FIPS,votes_dem_2016,votes_gop_2016,total_votes_2016,per_dem_2016,per_gop_2016,diff_2016,per_point_diff_2016,state_abbr,county_name,,total_votes_2012,votes_dem_2012,votes_gop_2012,per_dem_2012,per_gop_2012,diff_2012,per_point_diff_2012
1001,5908,18110,24661,0.23956855,0.734357893,12202,-0.494789343,AL,Autauga County,,23909,6354,17366,0.265757664,0.726337362,11012,-0.460579698
1003,18409,72780,94090,0.195653098,0.77351472,54371,-0.577861622,AL,Baldwin County,,84988,18329,65772,0.215665741,0.773897491,47443,-0.55823175
1005,4848,5431,10390,0.466602502,0.522714148,583,-0.056111646,AL,Barbour County,,11459,5873,5539,0.512522908,0.483375513,334,0.029147395
1007,1874,6733,8748,0.214220393,0.769661637,4859,-0.555441244,AL,Bibb County,,8391,2200,6131,0.262185675,0.730663806,3931,-0.468478131
1009,2150,22808,25384,0.084699023,0.898518752,20658,-0.813819729,AL,Blount County,,23980,2961,20741,0.123477898,0.864929108,17780,-0.741451209
1011,3530,1139,4701,0.750904063,0.242288875,2391,0.508615188,AL,Bullock County,,5318,4058,1250,0.763068823,0.235050771,2808,0.528018052
1013,3716,4891,8685,0.427864134,0.563154865,1175,-0.135290731,AL,Butler County,,9483,4367,5081,0.460508278,0.535800907,714,-0.075292629
1015,13197,32803,47376,0.278558764,0.692396994,19606,-0.41383823,AL,Calhoun County,,46240,15500,30272,0.335207612,0.65467128,14772,-0.319463668
1017,5763,7803,13778,0.418275512,0.56633764,2040,-0.148062128,AL,Chambers County,,14562,6853,7596,0.470608433,0.521631644,743,-0.051023211
1019,1524,8809,10503,0.1451014,0.838712749,7285,-0.693611349,AL,Cherokee County,,9761,2126,7494,0.217805553,0.767749206,5368,-0.549943653
1021,2909,15068,18255,0.159353602,0.825417694,12159,-0.666064092,AL,Chilton County,,17434,3391,13910,0.19450499,0.797866238,10519,-0.603361248
1023,3109,4102,7268,0.427765548,0.564391855,993,-0.136626307,AL,Choctaw County,,7965,3785,4150,0.475204018,0.521029504,365,-0.045825487
1025,5712,7109,12936,0.441558442,0.549551639,1397,-0.107993197,AL,Clarke County,,13827,6317,7463,0.456859767,0.539741086,1146,-0.082881319
1027,1234,5230,6572,0.187766281,0.795800365,3996,-0.608034084,AL,Clay County,,6640,1770,4802,0.266566265,0.723192771,3032,-0.456626506
1029,684,5738,6532,0.104715248,0.878444581,5054,-0.773729333,AL,Cleburne County,,6302,971,5269,0.15407807,0.836083783,4298,-0.682005712
1031,4194,15825,20513,0.204455711,0.771462,11631,-0.567006289,AL,Coffee County,,19715,4899,14638,0.248490997,0.742480345,9739,-0.493989348
1033,7296,16718,24626,0.296272233,0.678875985,9422,-0.382603752,AL,Colbert County,,23374,9160,13931,0.391888423,0.596004107,4771,-0.204115684
1035,3069,3413,6543,0.469050894,0.521626165,344,-0.052575271,AL,Conecuh County,,7013,3551,3434,0.506345359,0.489662056,117,0.016683302
1037,1780,3376,5223,0.340800306,0.646371817,1596,-0.305571511,AL,Coosa County,,5243,2188,3028,0.417318329,0.577531947,840,-0.160213618
1039,2379,13222,15818,0.15039828,0.835883171,10843,-0.685484891,AL,Covington County,,15415,3155,12148,0.204670775,0.788063574,8993,-0.583392799
1041,1663,4511,6252,0.265994882,0.721529111,2848,-0.455534229,AL,Crenshaw County,,6411,2048,4326,0.319450944,0.674777726,2278,-0.355326782
1043,3730,32734,37278,0.100059016,0.878105049,29004,-0.778046033,AL,Cullman County,,33178,4855,27930,0.146331907,0.841822895,23075,-0.695490988
1045,4408,13798,18617,0.236772842,0.741150561,9390,-0.504377719,AL,Dale County,,18551,5283,13105,0.284782492,0.70643092,7822,-0.421648429
1047,12826,5784,18730,0.684783769,0.308809397,7042,0.375974373,AL,Dallas County,,20936,14599,6284,0.697315629,0.300152847,8315,0.397162782
1049,3682,21779,26086,0.141148509,0.834892279,18097,-0.693743771,AL,DeKalb County,,23842,5235,18316,0.219570506,0.768224142,13081,-0.548653636
1051,8436,27619,36905,0.228586912,0.748380978,19183,-0.519794066,AL,Elmore County,,35440,8940,26223,0.252257336,0.739926637,17283,-0.4876693
1053,4698,10282,15213,0.308814829,0.675869322,5584,-0.367054493,AL,Escambia County,,14832,5476,9263,0.369201726,0.624528047,3787,-0.255326321
1055,10350,32132,43474,0.238073331,0.739108433,21782,-0.501035101,AL,Etowah County,,42490,12792,29102,0.301059073,0.684914097,16310,-0.383855025
1057,1358,6705,8196,0.165690581,0.818081991,5347,-0.65239141,AL,Fayette County,,7912,1803,6034,0.227881699,0.762639029,4231,-0.534757331
1059,2197,9466,11955,0.18377248,0.791802593,7269,-0.608030113,AL,Franklin County,,10859,3171,7567,0.292015839,0.69684133,4396,-0.40482549
1061,1522,9967,11659,0.130542928,0.854876061,8445,-0.724333133,AL,Geneva County,,11318,2039,9173,0.180155505,0.810478883,7134,-0.630323379
1063,4006,838,4862,0.823940765,0.172357055,3168,0.65158371,AL,Greene County,,5328,4514,799,0.847222222,0.149962462,3715,0.69725976
1065,4772,3172,8010,0.595755306,0.396004994,1600,0.199750312,AL,Hale County,,8628,5401,3205,0.625985165,0.371464998,2196,0.254520167
1067,2286,5623,8017,0.285144069,0.701384558,3337,-0.416240489,AL,Henry County,,8700,3046,5605,0.350114943,0.644252874,2559,-0.294137931
1069,10547,30567,42030,0.250939805,0.727266238,20020,-0.476326433,AL,Houston County,,41843,12348,29214,0.295103124,0.698181297,16866,-0.403078173
1071,3663,16643,20785,0.17623286,0.800721674,12980,-0.624488814,AL,Jackson County,,20555,5817,14422,0.282996838,0.701629774,8605,-0.418632936
1073,151581,130614,290111,0.522493115,0.450220778,20967,0.072272337,AL,Jefferson County,,303424,159658,141413,0.526187777,0.466057398,18245,0.060130379
1075,1035,5819,6931,0.149329101,0.839561391,4784,-0.69023229,AL,Lamar County,,7159,1643,5453,0.229501327,0.761698561,3810,-0.532197234
1077,9877,27735,38813,0.254476593,0.714580166,17858,-0.460103574,AL,Lauderdale County,,36908,12504,23902,0.338788339,0.647610274,11398,-0.308821936
1079,3611,10732,14623,0.246939752,0.73391233,7121,-0.486972577,AL,Lawrence County,,14079,5055,8855,0.359045387,0.62895092,3800,-0.269905533
1081,20987,34321,57668,0.363928002,0.595148089,13334,-0.231220087,AL,Lee County,,54115,21274,32062,0.393125751,0.59247898,10788,-0.199353229
1083,9340,28824,39400,0.237055838,0.731573604,19484,-0.494517766,AL,Limestone County,,35406,9809,25263,0.277043439,0.713523132,15454,-0.436479693
1085,4882,1751,6676,0.731276213,0.262282804,3131,0.468993409,AL,Lowndes County,,7519,5747,1754,0.764330363,0.233275702,3993,0.531054662
1087,7237,1394,8748,0.827274806,0.159350709,5843,0.667924097,AL,Macon County,,10385,9045,1322,0.870967742,0.127298989,7723,0.743668753
1089,62435,89199,159473,0.39150828,0.559336063,26764,-0.167827783,AL,Madison County,,154632,61802,90679,0.399671478,0.586418076,28877,-0.186746598
1091,5607,5224,10948,0.512148338,0.477164779,383,0.034983559,AL,Marengo County,,11509,6154,5321,0.534711965,0.462333826,833,0.072378139
1093,1432,11273,12912,0.110904585,0.873063817,9841,-0.762159232,AL,Marion County,,12104,2249,9696,0.185806345,0.801057502,7447,-0.615251157
1095,4913,29217,34965,0.140511941,0.835607036,24304,-0.695095095,AL,Marshall County,,32455,6271,25785,0.193221383,0.794484671,19514,-0.601263288
1097,68429,91087,163387,0.41881545,0.557492334,22658,-0.138676884,AL,Mobile County,,174189,78417,94566,0.450183421,0.542893064,16149,-0.092709643
1099,4310,5771,10185,0.42317133,0.566617575,1461,-0.143446244,AL,Monroe County,,10680,4897,5730,0.458520599,0.536516854,833,-0.077996255
1101,58669,33928,94572,0.620363321,0.358753119,24741,0.261610202,AL,Montgomery County,,101781,62993,38283,0.618907262,0.376131105,24710,0.242776157
1103,11216,37392,49991,0.224360385,0.747974635,26176,-0.523614251,AL,Morgan County,,49198,13401,35309,0.272389122,0.717691776,21908,-0.445302655
1105,3823,1403,5255,0.727497621,0.266983825,2420,0.460513796,AL,Perry County,,6065,4536,1504,0.747897774,0.247980214,3032,0.49991756
1107,3972,5454,9494,0.418369497,0.574468085,1482,-0.156098589,AL,Pickens County,,9599,4448,5119,0.463381602,0.533284717,671,-0.069903115
1109,5039,7681,13025,0.386871401,0.589712092,2642,-0.202840691,AL,Pike County,,14057,6009,7939,0.427473856,0.564772,1930,-0.137298143
1111,2290,7697,10130,0.226061204,0.75982231,5407,-0.533761106,AL,Randolph County,,10391,3076,7219,0.296025407,0.694735829,4143,-0.398710422
1113,9577,9210,19136,0.500470318,0.481291806,367,0.019178512,AL,Russell County,,18871,10495,8276,0.556144348,0.438556515,2219,0.117587833
1115,5550,31579,37937,0.146295174,0.832406358,26029,-0.686111184,AL,St. Clair County,,35105,5790,29001,0.16493377,0.826121635,23211,-0.661187865
1117,22927,72846,99208,0.231100314,0.734275462,49919,-0.503175147,AL,Shelby County,,92204,19944,71243,0.21630298,0.772667129,51299,-0.556364149
1119,4739,1581,6391,0.741511501,0.247379127,3158,0.494132374,AL,Sumter County,,7025,5420,1585,0.771530249,0.225622776,3835,0.545907473
1121,12108,20596,33218,0.364501174,0.620025287,8488,-0.255524113,AL,Talladega County,,33317,13878,19217,0.416544107,0.576792628,5339,-0.160248522
1123,5271,12967,18504,0.284857328,0.700767402,7696,-0.415910073,AL,Tallapoosa County,,18668,6252,12303,0.33490465,0.659042211,6051,-0.324137562
1125,31746,47701,81708,0.388529887,0.583798404,15955,-0.195268517,AL,Tuscaloosa County,,78495,32003,45703,0.407707497,0.582240907,13700,-0.17453341
1127,4486,24208,29243,0.153404233,0.827822043,19722,-0.674417809,AL,Walker County,,28497,6551,21633,0.229883847,0.75913254,15082,-0.529248693
1129,2366,6031,8492,0.278615167,0.710197833,3665,-0.431582666,AL,Washington County,,8761,2971,5749,0.339116539,0.65620363,2778,-0.317087091
1131,4329,1737,6095,0.710254307,0.284987695,2592,0.425266612,AL,Wilcox County,,6547,4867,1676,0.743393921,0.255995112,3191,0.487398809
1133,871,9225,10255,0.084934178,0.89956119,8354,-0.814627011,AL,Winston County,,9712,1286,8310,0.132413509,0.855642504,7024,-0.723228995
2013,93003,130413,246588,0.377159472,0.528870018,37410,-0.151710546,AK,Alaska,,,,,,,,
2016,93003,130413,246588,0.377159472,0.528870018,37410,-0.151710546,AK,Alaska,,,,,,,,
2020,93003,130413,246588,0.377159472,0.528870018,37410,-0.151710546,AK,Alaska,,,,,,,,
2050,93003,130413,246588,0.377159472,0.528870018,37410,-0.151710546,AK,Alaska,,,,,,,,
2060,93003,130413,246588,0.377159472,0.528870018,37410,-0.151710546,AK,Alaska,,,,,,,,
2068,93003,130413,246588,0.377159472,0.528870018,37410,-0.151710546,AK,Alaska,,,,,,,,
2070,93003,130413,246588,0.377159472,0.528870018,37410,-0.151710546,AK,Alaska,,,,,,,,
2090,93003,130413,246588,0.377159472,0.528870018,37410,-0.151710546,AK,Alaska,,,,,,,,
2100,93003,130413,246588,0.377159472,0.528870018,37410,-0.151710546,AK,Alaska,,,,,,,,
2105,93003,130413,246588,0.377159472,0.528870018,37410,-0.151710546,AK,Alaska,,,,,,,,
2110,93003,130413,246588,0.377159472,0.528870018,37410,-0.151710546,AK,Alaska,,,,,,,,
2122,93003,130413,246588,0.377159472,0.528870018,37410,-0.151710546,AK,Alaska,,,,,,,,
2130,93003,130413,246588,0.377159472,0.528870018,37410,-0.151710546,AK,Alaska,,,,,,,,
2150,93003,130413,246588,0.377159472,0.528870018,37410,-0.151710546,AK,Alaska,,,,,,,,
2164,93003,130413,246588,0.377159472,0.528870018,37410,-0.151710546,AK,Alaska,,,,,,,,
2170,93003,130413,246588,0.377159472,0.528870018,37410,-0.151710546,AK,Alaska,,,,,,,,
2180,93003,130413,246588,0.377159472,0.528870018,37410,-0.151710546,AK,Alaska,,,,,,,,
2185,93003,130413,246588,0.377159472,0.528870018,37410,-0.151710546,AK,Alaska,,,,,,,,
2188,93003,130413,246588,0.377159472,0.528870018,37410,-0.151710546,AK,Alaska,,,,,,,,
2195,93003,130413,246588,0.377159472,0.528870018,37410,-0.151710546,AK,Alaska,,,,,,,,
2198,93003,130413,246588,0.377159472,0.528870018,37410,-0.151710546,AK,Alaska,,,,,,,,
2220,93003,130413,246588,0.377159472,0.528870018,37410,-0.151710546,AK,Alaska,,,,,,,,
2230,93003,130413,246588,0.377159472,0.528870018,37410,-0.151710546,AK,Alaska,,,,,,,,
2240,93003,130413,246588,0.377159472,0.528870018,37410,-0.151710546,AK,Alaska,,,,,,,,
2261,93003,130413,246588,0.377159472,0.528870018,37410,-0.151710546,AK,Alaska,,,,,,,,
2270,93003,130413,246588,0.377159472,0.528870018,37410,-0.151710546,AK,Alaska,,,,,,,,
2275,93003,130413,246588,0.377159472,0.528870018,37410,-0.151710546,AK,Alaska,,,,,,,,
2282,93003,130413,246588,0.377159472,0.528870018,37410,-0.151710546,AK,Alaska,,,,,,,,
2290,93003,130413,246588,0.377159472,0.528870018,37410,-0.151710546,AK,Alaska,,,,,,,,
4001,12196,5315,18659,0.653625596,0.284849134,6881,0.368776462,AZ,Apache County,,25465,16833,8198,0.661024936,0.321932064,8635,0.339092873
4003,15291,25036,43147,0.354393121,0.580248916,9745,-0.225855795,AZ,Cochise County,,43776,16223,26742,0.370591192,0.610882675,10519,-0.240291484
4005,25308,16573,44929,0.563288744,0.368870885,8735,0.194417859,AZ,Coconino County,,46746,26316,19368,0.562957258,0.41432422,6948,0.148633038
4007,6746,13672,21398,0.315263109,0.638938219,6926,-0.32367511,AZ,Gila County,,18477,6650,11525,0.359906911,0.623748444,4875,-0.263841533
4009,3301,8025,11939,0.276488818,0.672166848,4724,-0.39567803,AZ,Graham County,,11854,3608,8076,0.304369833,0.681289016,4468,-0.376919183
4011,1092,1892,3243,0.336725254,0.583410422,800,-0.246685168,AZ,Greenlee County,,2972,1310,1590,0.440780619,0.534993271,280,-0.094212651
4012,1318,3381,4931,0.267288582,0.685662137,2063,-0.418373555,AZ,La Paz County,,4922,1619,3205,0.328931329,0.651158066,1586,-0.322226737
4013,549040,590465,1201934,0.456797129,0.491262415,41425,-0.034465287,AZ,Maricopa County,,1187008,512008,654835,0.431343344,0.551668565,142827,-0.120325221
4015,16485,54656,74189,0.222202752,0.73671299,38171,-0.514510237,AZ,Mohave County,,65949,18324,46442,0.277851067,0.70421083,28118,-0.426359763
4017,15362,18165,35409,0.433844503,0.513005168,2803,-0.079160665,AZ,Navajo County,,35775,16157,19155,0.451628232,0.535429769,2998,-0.083801537
4019,195649,147019,360762,0.542321531,0.40752352,48630,0.134798011,AZ,Pima County,,351817,183470,162927,0.521492708,0.463101556,20543,0.058391152
4021,35737,53857,93805,0.380971164,0.574137839,18120,-0.193166676,AZ,Pinal County,,102139,41428,58947,0.405604128,0.57712529,17519,-0.171521162
4023,10684,3650,14926,0.715797936,0.244539729,7034,0.471258207,AZ,Santa Cruz County,,13894,9486,4235,0.682740751,0.304807831,5251,0.377932921
4025,29705,58862,92780,0.320165984,0.634425523,29157,-0.314259539,AZ,Yavapai County,,96790,32624,62385,0.337059614,0.644539725,29761,-0.307480112
4027,18336,20586,40759,0.449863834,0.505066366,2250,-0.055202532,AZ,Yuma County,,33935,14025,19500,0.413290113,0.574627965,5475,-0.161337852
5001,1939,3825,6167,0.314415437,0.620236744,1886,-0.305821307,AR,Arkansas County,,6488,2454,3892,0.378236745,0.599876695,1438,-0.221639951
5003,2408,5338,8027,0.299987542,0.665005606,2930,-0.365018064,AR,Ashley County,,7915,2855,4866,0.360707517,0.614782059,2011,-0.254074542
5005,4163,14655,19572,0.212701819,0.748773758,10492,-0.53607194,AR,Baxter County,,19339,5172,13688,0.267438854,0.707792544,8516,-0.440353689
5007,27894,60751,94262,0.295919883,0.644490887,32857,-0.348571004,AR,Benton County,,77525,22144,53477,0.285636891,0.689803289,31333,-0.404166398
5009,2925,12225,15912,0.183823529,0.768288084,9300,-0.584464555,AR,Boone County,,15363,3762,11143,0.244874048,0.725314066,7381,-0.480440018
5011,1317,2163,3617,0.364113907,0.5980094,846,-0.233895494,AR,Bradley County,,3634,1447,2118,0.398183819,0.582828839,671,-0.184645019
5013,636,1554,2250,0.282666667,0.690666667,918,-0.408,AR,Calhoun County,,2174,660,1458,0.303587856,0.670653174,798,-0.367065317
5015,3334,6773,10656,0.312875375,0.635604354,3439,-0.322728979,AR,Carroll County,,10172,3691,6121,0.362858828,0.601749902,2430,-0.238891074
5017,2350,1716,4149,0.566401543,0.413593637,634,0.152807906,AR,Chicot County,,4361,2649,1670,0.607429489,0.382939693,979,0.224489796
5019,3606,4398,8365,0.431081889,0.525762104,792,-0.094680215,AR,Clark County,,8406,3808,4343,0.453009755,0.51665477,535,-0.063645015
5021,1999,3779,5978,0.334392774,0.632151221,1780,-0.297758448,AR,Clay County,,5110,1738,3225,0.340117417,0.63111546,1487,-0.290998043
5023,2101,9454,11968,0.175551471,0.78993984,7353,-0.614388369,AR,Cleburne County,,11643,2618,8691,0.224856137,0.746457099,6073,-0.521600962
5025,723,2460,3299,0.21915732,0.745680509,1737,-0.526523189,AR,Cleveland County,,3266,845,2313,0.258726271,0.708205756,1468,-0.449479486
5027,3140,5456,8837,0.355324205,0.617404096,2316,-0.262079891,AR,Columbia County,,9455,3557,5790,0.376203067,0.612374405,2233,-0.236171338
5029,2655,4844,7837,0.338777593,0.618093658,2189,-0.279316065,AR,Conway County,,7724,3003,4511,0.388788193,0.584023822,1508,-0.195235629
5031,10474,22798,34968,0.299531,0.651967513,12324,-0.352436513,AR,Craighead County,,31207,10351,20044,0.331688403,0.642291794,9693,-0.31060339
5033,4476,16655,22155,0.202031144,0.751749041,12179,-0.549717897,AR,Crawford County,,20562,4872,15125,0.236941932,0.735580196,10253,-0.498638265
5035,8368,6953,15798,0.529687302,0.440119002,1415,0.0895683,AR,Crittenden County,,15513,9092,6192,0.586089087,0.399149101,2900,0.186939986
5037,1995,4577,6831,0.292050944,0.67003367,2582,-0.377982726,AR,Cross County,,6680,2279,4268,0.341167665,0.638922156,1989,-0.297754491
5039,1165,1507,2741,0.425027362,0.549799343,342,-0.124771981,AR,Dallas County,,3083,1337,1664,0.433668505,0.539734025,327,-0.106065521
5041,2227,1915,4226,0.526975864,0.453147184,312,0.07382868,AR,Desha County,,4240,2353,1807,0.55495283,0.426179245,546,0.128773585
5043,2364,3967,6552,0.360805861,0.60546398,1603,-0.24465812,AR,Drew County,,6626,2627,3883,0.396468458,0.586024751,1256,-0.189556293
5045,14525,29170,46364,0.313281857,0.629151928,14645,-0.315870072,AR,Faulkner County,,41322,13559,26653,0.328130294,0.645007502,13094,-0.316877208
5047,1376,5034,6698,0.205434458,0.751567632,3658,-0.546133174,AR,Franklin County,,6539,1725,4631,0.263801805,0.708212265,2906,-0.44441046
5049,1067,3470,4744,0.224915683,0.731450253,2403,-0.50653457,AR,Fulton County,,4522,1452,2949,0.32109686,0.652145069,1497,-0.331048209
5051,12283,26053,40337,0.304509507,0.645883432,13770,-0.341373925,AR,Garland County,,39241,13317,25031,0.33936444,0.637878749,11714,-0.298514309
5053,1407,5160,6855,0.205251641,0.75273523,3753,-0.547483589,AR,Grant County,,6478,1467,4829,0.226458784,0.745446125,3362,-0.518987342
5055,3056,10698,14422,0.211898488,0.741783386,7642,-0.529884898,AR,Greene County,,13754,3998,9066,0.290679075,0.659153701,5068,-0.368474626
5057,2371,4391,6984,0.339490263,0.628722795,2020,-0.289232532,AR,Hempstead County,,6919,2466,4284,0.356409886,0.619164619,1818,-0.262754733
5059,3137,8153,11815,0.265509945,0.690055015,5016,-0.42454507,AR,Hot Spring County,,11239,3824,7087,0.340243794,0.630572115,3263,-0.290328321
5061,1350,3155,4634,0.291324989,0.68083729,1805,-0.3895123,AR,Howard County,,4419,1460,2862,0.330391491,0.647657841,1402,-0.31726635
5063,2878,9925,13443,0.214089117,0.738302462,7047,-0.524213345,AR,Independence County,,12390,3279,8724,0.26464891,0.704116223,5445,-0.439467312
5065,1111,4042,5396,0.205893254,0.749073388,2931,-0.543180133,AR,Izard County,,5313,1563,3571,0.294184077,0.672124976,2008,-0.3779409
5067,1583,3262,5093,0.310818771,0.640486943,1679,-0.329668172,AR,Jackson County,,5338,2093,3065,0.392094417,0.574185088,972,-0.182090671
5069,15721,9231,25683,0.612116965,0.359420628,6490,0.252696336,AR,Jefferson County,,27364,17456,9515,0.637918433,0.347719632,7941,0.290198801
5071,2421,6072,8997,0.269089697,0.674891631,3651,-0.405801934,AR,Johnson County,,8064,2785,5045,0.345362103,0.62562004,2260,-0.280257937
5073,1028,1750,2835,0.362610229,0.617283951,722,-0.254673721,AR,Lafayette County,,2928,1173,1712,0.400614754,0.584699454,539,-0.184084699
5075,1263,4064,5629,0.224373779,0.721975484,2801,-0.497601705,AR,Lawrence County,,5537,1786,3535,0.322557342,0.638432364,1749,-0.315875023
5077,1735,1229,3004,0.577563249,0.409121172,506,0.168442077,AR,Lee County,,3424,2107,1280,0.61536215,0.373831776,827,0.241530374
5079,1252,2455,3814,0.328264289,0.643681175,1203,-0.315416885,AR,Lincoln County,,3725,1424,2199,0.382281879,0.59033557,775,-0.208053691
5081,1397,3604,5192,0.269067797,0.694144838,2207,-0.425077042,AR,Little River County,,5051,1552,3385,0.307265888,0.670164324,1833,-0.362898436
5083,1712,5737,7839,0.218395203,0.731853553,4025,-0.513458349,AR,Logan County,,7330,2009,5078,0.274079127,0.692769441,3069,-0.418690314
5085,5638,19902,26766,0.210640365,0.743555257,14264,-0.532914892,AR,Lonoke County,,24083,5612,17863,0.233027447,0.741726529,12251,-0.508699082
5087,1587,4917,6782,0.234001769,0.725007372,3330,-0.491005603,AR,Madison County,,6567,2099,4262,0.319628445,0.649002589,2163,-0.329374143
5089,1377,5077,6718,0.204971718,0.755730872,3700,-0.550759155,AR,Marion County,,7029,2024,4771,0.287949922,0.678759425,2747,-0.390809503
5091,4273,11293,16015,0.266812363,0.705151421,7020,-0.438339057,AR,Miller County,,15329,4518,10622,0.294735469,0.69293496,6104,-0.398199491
5093,5621,6988,12995,0.432550981,0.537745287,1367,-0.105194306,AR,Mississippi County,,13349,6445,6599,0.482807701,0.494344146,154,-0.011536445
5095,1298,1400,2766,0.469269704,0.506146059,102,-0.036876356,AR,Monroe County,,3230,1583,1585,0.490092879,0.490712074,2,-0.000619195
5097,735,2573,3445,0.213352685,0.746879536,1838,-0.533526851,AR,Montgomery County,,3403,920,2368,0.270349691,0.695856597,1448,-0.425506906
5099,1156,2001,3233,0.357562635,0.618929787,845,-0.261367151,AR,Nevada County,,3384,1314,1996,0.388297872,0.589834515,682,-0.201536643
5101,699,2875,3731,0.187349236,0.770570893,2176,-0.583221656,AR,Newton County,,3661,993,2508,0.271237367,0.685058727,1515,-0.41382136
5103,4320,5347,9881,0.437202712,0.541139561,1027,-0.103936848,AR,Ouachita County,,10303,4626,5516,0.448995438,0.535378045,890,-0.086382607
5105,1035,2979,4213,0.24566817,0.70709708,1944,-0.461428911,AR,Perry County,,3937,1187,2580,0.301498603,0.655321311,1393,-0.353822708
5107,4292,2443,6894,0.622570351,0.354366115,1849,0.268204236,AR,Phillips County,,7900,5179,2591,0.65556962,0.327974684,2588,0.327594937
5109,684,3150,3956,0.172901921,0.796258847,2466,-0.623356926,AR,Pike County,,3787,850,2847,0.224452073,0.751782414,1997,-0.527330341
5111,1878,3149,5283,0.355479841,0.596062843,1271,-0.240583002,AR,Poinsett County,,7550,2387,4967,0.31615894,0.657880795,2580,-0.341721854
5113,1210,6606,8121,0.148996429,0.81344662,5396,-0.664450191,AR,Polk County,,7721,1556,5950,0.201528299,0.770625567,4394,-0.569097267
5115,4818,15694,21545,0.223624971,0.72842887,10876,-0.504803899,AR,Pope County,,20390,5108,14733,0.250514958,0.722560078,9625,-0.47204512
5117,812,2503,3404,0.238542891,0.735311398,1691,-0.496768508,AR,Prairie County,,3134,877,2149,0.279834078,0.685705169,1272,-0.405871091
5119,89377,61182,157728,0.566652719,0.387895618,28195,0.178757101,AR,Pulaski County,,159055,87055,68856,0.547326397,0.432906856,18199,0.11441954
5121,1425,4508,6313,0.225724695,0.714082053,3083,-0.488357358,AR,Randolph County,,5948,2040,3699,0.342972428,0.621889711,1659,-0.278917283
5123,4031,3195,7412,0.543847814,0.431057744,836,0.11279007,AR,St. Francis County,,8021,4652,3287,0.579977559,0.409799277,1365,0.170178282
5125,13247,35852,51971,0.254892151,0.68984626,22605,-0.434954109,AR,Saline County,,47059,12868,32962,0.273443975,0.700439873,20094,-0.426995899
5127,507,2378,3017,0.16804773,0.788200199,1871,-0.620152469,AR,Scott County,,3637,895,2630,0.246081936,0.723123453,1735,-0.477041518
5129,601,2955,3698,0.162520281,0.799080584,2354,-0.636560303,AR,Searcy County,,3694,814,2699,0.220357336,0.730644288,1885,-0.510286952
5131,12184,28769,43557,0.279725417,0.660490851,16585,-0.380765434,AR,Sebastian County,,43340,13083,29158,0.301868943,0.672773419,16075,-0.370904476
5133,1075,3281,4517,0.237989816,0.726367058,2206,-0.488377242,AR,Sevier County,,4328,1042,3135,0.240757856,0.72435305,2093,-0.483595194
5135,1472,5405,7190,0.20472879,0.751738526,3933,-0.547009736,AR,Sharp County,,7282,2092,4920,0.287283713,0.675638561,2828,-0.388354848
5137,1189,4081,5527,0.215125746,0.738375249,2892,-0.523249502,AR,Stone County,,5351,1356,3773,0.253410577,0.70510185,2417,-0.451691273
5139,5667,10201,16338,0.346860081,0.624372628,4534,-0.277512547,AR,Union County,,17160,6182,10696,0.36025641,0.623310023,4514,-0.263053613
5141,1547,5382,7111,0.217550274,0.756855576,3835,-0.539305302,AR,Van Buren County,,6421,1826,4362,0.28437938,0.679333437,2536,-0.394954057
5143,32296,40418,78153,0.413240695,0.517165048,8122,-0.103924354,AR,Washington County,,70231,28136,39570,0.400620808,0.563426407,11434,-0.162805599
5145,5157,21038,27451,0.187862009,0.766383738,15881,-0.57852173,AR,White County,,26508,5765,20005,0.217481515,0.754677833,14240,-0.537196318
5147,1117,1344,2550,0.438039216,0.527058824,227,-0.089019608,AR,Woodruff County,,2685,1340,1227,0.499068901,0.45698324,113,0.042085661
5149,1472,4600,6389,0.230395993,0.719987478,3128,-0.489591485,AR,Yell County,,5971,1720,4041,0.288058952,0.67677106,2321,-0.388712109
6001,486351,91189,613195,0.793142475,0.148711258,395162,0.644431217,CA,Alameda County,,558386,438091,104330,0.78456659,0.186842077,333761,0.597724513
6003,318,211,575,0.553043478,0.366956522,107,0.186086957,CA,Alpine County,,647,389,236,0.601236476,0.364760433,153,0.236476043
6005,5904,10239,17186,0.343535436,0.595775631,4335,-0.252240196,CA,Amador County,,15303,6001,8903,0.392145331,0.58178135,2902,-0.189636019
6007,38676,42193,87847,0.440265462,0.480300978,3517,-0.040035516,CA,Butte County,,70163,32567,35312,0.464162023,0.503285207,2745,-0.039123185
6009,7738,13072,22334,0.34646727,0.585295961,5334,-0.238828692,CA,Calaveras County,,18469,7404,10537,0.400887974,0.57052358,3133,-0.169635606
6011,2518,3464,6346,0.396785377,0.545855657,946,-0.14907028,CA,Colusa County,,5865,2248,3521,0.383290708,0.600341006,1273,-0.217050298
6013,286658,105819,415972,0.689128114,0.254389719,180839,0.434738396,CA,Contra Costa County,,351257,230826,112547,0.657142776,0.32041212,118279,0.336730656
6015,3485,5134,9361,0.372289285,0.548445679,1649,-0.176156394,CA,Del Norte County,,7940,3396,4256,0.427707809,0.536020151,860,-0.108312343
6017,35243,47633,89228,0.394976913,0.533834671,12390,-0.138857758,CA,El Dorado County,,85923,34033,49661,0.396087194,0.577970974,15628,-0.18188378
6019,123660,113949,250264,0.494118211,0.455315187,9711,0.038803024,CA,Fresno County,,180244,85862,91143,0.476365371,0.505664544,5281,-0.029299172
6021,3065,5788,9379,0.326793901,0.617123361,2723,-0.290329459,CA,Glenn County,,9142,3276,5608,0.358346095,0.613432509,2332,-0.255086414
6023,19596,10883,33636,0.582590082,0.323552147,8713,0.259037936,CA,Humboldt County,,46269,27757,15653,0.599904904,0.338304264,12104,0.26160064
6025,23887,9318,34807,0.686270003,0.267704772,14569,0.418565231,CA,Imperial County,,27453,17464,9545,0.63614177,0.347685135,7919,0.288456635
6027,3155,4248,7996,0.394572286,0.531265633,1093,-0.136693347,CA,Inyo County,,6501,2775,3541,0.426857407,0.544685433,766,-0.117828026
6029,86481,119164,217725,0.397202894,0.547314273,32683,-0.150111379,CA,Kern County,,168116,64690,99840,0.384793833,0.593875657,35150,-0.209081824
6031,12902,17446,32250,0.400062016,0.54096124,4544,-0.140899225,CA,Kings County,,30139,12282,17184,0.407511862,0.570158267,4902,-0.162646405
6033,6240,5752,13045,0.478344193,0.440935224,488,0.037408969,CA,Lake County,,16274,9159,6474,0.562799558,0.397812462,2685,0.164987096
6035,2224,7574,10422,0.213394742,0.726731913,5350,-0.513337171,CA,Lassen County,,10603,3044,7261,0.28708856,0.684806187,4217,-0.397717627
6037,1893770,620285,2652072,0.714071865,0.233886938,1273485,0.480184927,CA,Los Angeles County,,2427869,1672164,699600,0.688737325,0.288153933,972564,0.400583392
6039,13283,19221,34263,0.38767767,0.560984152,5938,-0.173306482,CA,Madera County,,32372,12698,18990,0.392252564,0.586618065,6292,-0.194365501
6041,69518,14214,88115,0.788946263,0.161311922,55304,0.627634341,CA,Marin County,,99286,73450,23347,0.739782044,0.235148964,50103,0.50463308
6043,3122,5185,8877,0.351695393,0.584093725,2063,-0.232398333,CA,Mariposa County,,7805,3080,4434,0.394618834,0.568097373,1354,-0.173478539
6045,6905,3571,11435,0.603847836,0.312286839,3334,0.291560997,CA,Mendocino County,,17928,11869,5129,0.662037037,0.2860888,6740,0.375948237
6047,21856,18486,42523,0.513980669,0.434729441,3370,0.079251229,CA,Merced County,,50538,26128,23403,0.516997111,0.463077288,2725,0.053919823
6049,798,2413,3359,0.237570706,0.718368562,1615,-0.480797857,CA,Modoc County,,3986,1113,2779,0.279227296,0.697190166,1666,-0.41796287
6051,2696,2080,5154,0.523088863,0.403570043,616,0.11951882,CA,Mono County,,4917,2574,2202,0.523489933,0.447834045,372,0.075655888
6053,64733,26378,96676,0.669587074,0.272849518,38355,0.396737556,CA,Monterey County,,78522,51712,25087,0.658567026,0.319490079,26625,0.339076947
6055,26161,11946,40393,0.647661724,0.295744312,14215,0.351917411,CA,Napa County,,32332,19964,11647,0.617468762,0.36023135,8317,0.257237412
6057,16199,14686,33258,0.48707078,0.441577966,1513,0.045492814,CA,Nevada County,,30864,14261,15696,0.462059357,0.508553655,1435,-0.046494298
6059,556544,472669,1092116,0.509601544,0.432801094,83875,0.07680045,CA,Orange County,,1021315,457077,541592,0.447537733,0.530288892,84515,-0.082751159
6061,61969,78977,150532,0.411666622,0.524652566,17008,-0.112985943,CA,Placer County,,126325,49126,74460,0.38888581,0.589432021,25334,-0.20054621
6063,3224,5079,8830,0.365118913,0.575198188,1855,-0.210079275,CA,Plumas County,,9128,3670,5240,0.402059597,0.574057844,1570,-0.171998247
6065,300686,279072,609869,0.49303375,0.457593352,21614,0.035440398,CA,Riverside County,,589721,287754,290227,0.487949386,0.492142895,2473,-0.004193508
6067,273768,163024,467526,0.585567434,0.348695046,110744,0.236872388,CA,Sacramento County,,388090,221063,157688,0.569617872,0.406318122,63375,0.16329975
6069,8309,5530,14688,0.565699891,0.376497821,2779,0.18920207,CA,San Benito County,,14972,8617,6052,0.57554101,0.404221213,2565,0.171319797
6071,304407,249103,585169,0.520203565,0.425694116,55304,0.094509449,CA,San Bernardino County,,531692,274203,245468,0.515717746,0.4616733,28735,0.054044447
6073,567243,386807,1011651,0.560710166,0.382352214,180436,0.178357952,CA,San Diego County,,928256,478386,431046,0.515359987,0.464361125,47340,0.050998862
6075,312443,34493,365295,0.855316936,0.094425054,277950,0.760891882,CA,San Francisco County,,321023,267857,42654,0.834385698,0.132868984,225203,0.701516714
6077,71349,56194,134076,0.532153406,0.419120499,15155,0.113032907,CA,San Joaquin County,,149587,80005,66742,0.534839257,0.446175136,13263,0.088664122
6079,61021,50755,120296,0.507257099,0.421917603,10266,0.085339496,CA,San Luis Obispo County,,117597,57655,56500,0.490276112,0.480454433,1155,0.009821679
6081,192035,47627,251646,0.763115647,0.1892619,144408,0.573853747,CA,San Mateo County,,211814,151036,56244,0.713059571,0.265534856,94792,0.447524715
6083,100120,53740,164224,0.609655105,0.32723597,46380,0.282419135,CA,Santa Barbara County,,147249,84279,59096,0.572357028,0.401333795,25183,0.171023233
6085,483472,137452,659148,0.73348019,0.208529799,346020,0.524950391,CA,Santa Clara County,,491687,343239,136347,0.69808435,0.277304464,206892,0.420779886
6087,85185,20158,113509,0.750469126,0.177589442,65027,0.572879684,CA,Santa Cruz County,,81294,61106,17132,0.75166679,0.21074126,43974,0.54092553
6089,20471,47587,72554,0.282148469,0.655883893,27116,-0.373735425,CA,Shasta County,,54121,18184,34561,0.335987879,0.638587609,16377,-0.30259973
6091,601,1048,1804,0.333148559,0.580931264,447,-0.247782705,CA,Sierra County,,1779,652,1056,0.366498033,0.593591906,404,-0.227093873
6093,7106,11212,19836,0.358237548,0.565234926,4106,-0.206997379,CA,Siskiyou County,,17505,7110,9844,0.406169666,0.562353613,2734,-0.156183947
6095,94622,48712,152398,0.620887413,0.319636741,45910,0.301250673,CA,Solano County,,138565,87225,48364,0.629487966,0.349034749,38861,0.280453217
6097,116027,37421,164060,0.707222967,0.22809338,78606,0.479129587,CA,Sonoma County,,175738,124504,45666,0.708463736,0.259852735,78838,0.448611
6099,73939,72960,156141,0.473539941,0.467269968,979,0.006269974,CA,Stanislaus County,,143620,70609,69549,0.491637655,0.484257067,1060,0.007380588
6101,11831,16780,30429,0.38880673,0.551447632,4949,-0.162640902,CA,Sutter County,,20988,8004,12576,0.381360778,0.599199543,4572,-0.217838765
6103,6571,14981,22875,0.287256831,0.654907104,8410,-0.367650273,CA,Tehama County,,17356,6032,10791,0.347545517,0.621744642,4759,-0.274199124
6105,1876,2409,4716,0.397794741,0.510814249,533,-0.113019508,CA,Trinity County,,5030,2367,2422,0.470576541,0.481510934,55,-0.010934394
6107,27975,38062,69408,0.403051521,0.54838059,10087,-0.145329069,CA,Tulare County,,72832,29191,42186,0.400799099,0.579223418,12995,-0.178424319
6109,8580,13486,23472,0.365541922,0.574556919,4906,-0.209014997,CA,Tuolumne County,,23730,9628,13410,0.405731142,0.565107459,3782,-0.159376317
6111,170489,118764,307881,0.553749663,0.385746441,51725,0.168003222,CA,Ventura County,,267907,138119,123919,0.515548306,0.462544838,14200,0.053003468
6113,34460,13178,50623,0.680718251,0.260316457,21282,0.420401794,CA,Yolo County,,59613,38856,19080,0.651804137,0.320064415,19776,0.331739721
6115,7234,12313,21058,0.343527401,0.584718397,5079,-0.241190996,CA,Yuba County,,15009,5817,8746,0.38756746,0.582717036,2929,-0.195149577
8001,86471,73807,175125,0.493767309,0.421453248,12664,0.072314061,CO,Adams County,,161495,90843,66531,0.562512771,0.411969411,24312,0.15054336
8003,3168,3031,6897,0.459330144,0.439466435,137,0.019863709,CO,Alamosa County,,6671,3782,2693,0.566931495,0.403687603,1089,0.163243891
8005,148365,109638,281658,0.526755853,0.389259314,38727,0.137496538,CO,Arapahoe County,,254746,135433,114232,0.531639358,0.448415284,21201,0.083224074
8007,2489,4234,7290,0.341426612,0.58079561,1745,-0.239368999,CO,Archuleta County,,6646,2637,3831,0.396780018,0.576436955,1194,-0.179656937
8009,278,1716,2107,0.131941149,0.814428097,1438,-0.682486948,CO,Baca County,,2096,462,1554,0.220419847,0.741412214,1092,-0.520992366
8011,581,1166,1892,0.307082452,0.61627907,585,-0.309196617,CO,Bent County,,1881,778,1053,0.413609782,0.559808612,275,-0.14619883
8013,124715,38766,176735,0.705661018,0.219345348,85949,0.48631567,CO,Boulder County,,173207,120485,48526,0.695612764,0.280161887,71959,0.415450877
8014,19530,14272,37342,0.523003588,0.38219699,5258,0.140806598,CO,Broomfield County,,32191,16653,14765,0.517318505,0.458668572,1888,0.058649933
8015,4773,5283,10999,0.433948541,0.480316392,510,-0.046367852,CO,Chaffee County,,10217,4967,4949,0.486150533,0.484388764,18,0.00176177
8017,127,905,1076,0.11802974,0.841078067,778,-0.723048327,CO,Cheyenne County,,1045,162,858,0.155023923,0.821052632,696,-0.666028708
8019,2585,2426,5532,0.467281273,0.438539407,159,0.028741866,CO,Clear Creek County,,5610,3041,2381,0.542067736,0.424420677,660,0.117647059
8021,1753,1885,3970,0.441561713,0.474811083,132,-0.03324937,CO,Conejos County,,4027,2180,1794,0.541345915,0.445492923,386,0.095852992
8023,1109,581,1820,0.609340659,0.319230769,528,0.29010989,CO,Costilla County,,1804,1317,440,0.730044346,0.243902439,877,0.486141907
8025,336,1069,1511,0.222369292,0.707478491,733,-0.485109199,CO,Crowley County,,1502,535,924,0.356191744,0.61517976,389,-0.258988016
8027,797,2059,3064,0.260117493,0.671997389,1262,-0.411879896,CO,Custer County,,2697,862,1776,0.319614386,0.658509455,914,-0.338895069
8029,4048,11584,16661,0.242962607,0.695276394,7536,-0.452313787,CO,Delta County,,15681,4542,10762,0.289649895,0.686308271,6220,-0.396658376
8031,174611,43637,232291,0.751690767,0.187854889,130974,0.563835878,CO,Denver County,,285564,209759,69755,0.73454287,0.244270987,140004,0.490271883
8033,227,936,1230,0.184552846,0.76097561,709,-0.576422764,CO,Dolores County,,1218,329,838,0.270114943,0.688013136,509,-0.417898194
8035,67045,100178,182918,0.366530358,0.547666167,33133,-0.181135809,CO,Douglas County,,150160,54093,93930,0.360235749,0.625532765,39837,-0.265297017
8037,12652,8153,22611,0.559550661,0.36057671,4499,0.198973951,CO,Eagle County,,22374,12598,9317,0.563064271,0.416420846,3281,0.146643425
8039,3056,11536,15689,0.194786156,0.735292243,8480,-0.540506087,CO,Elbert County,,13993,3542,10148,0.253126563,0.725219753,6606,-0.472093189
8041,105807,176506,313273,0.337746949,0.563425511,70699,-0.225678562,CO,El Paso County,,275604,104989,163819,0.380941496,0.594399936,58830,-0.21345844
8043,5275,15066,21880,0.241087751,0.68857404,9791,-0.447486289,CO,Fremont County,,20258,6644,13087,0.327969197,0.646016389,6443,-0.318047191
8045,11205,13071,26328,0.425592525,0.496467639,1866,-0.070875114,CO,Garfield County,,23695,10989,12159,0.463768728,0.513146233,1170,-0.049377506
8047,1634,1564,3574,0.457190823,0.437604924,70,0.019585898,CO,Gilpin County,,3271,1854,1320,0.566799144,0.403546316,534,0.163252828
8049,3319,4467,8513,0.38987431,0.524726888,1148,-0.134852578,CO,Grand County,,7961,3575,4149,0.449064188,0.521165683,574,-0.072101495
8051,5068,3250,9299,0.545004839,0.349499946,1818,0.195504893,CO,Gunnison County,,7912,4563,3106,0.576718908,0.392568251,1457,0.184150657
8053,197,339,589,0.334465195,0.575551783,142,-0.241086587,CO,Hinsdale County,,598,228,352,0.381270903,0.588628763,124,-0.20735786
8055,1631,1875,3772,0.432396607,0.497083775,244,-0.064687169,CO,Huerfano County,,3623,1897,1615,0.523599227,0.44576318,282,0.077836047
8057,171,628,862,0.19837587,0.728538283,457,-0.530162413,CO,Jackson County,,848,216,600,0.254716981,0.70754717,384,-0.452830189
8059,151885,130233,309529,0.490697156,0.420745714,21652,0.069951442,CO,Jefferson County,,300151,153069,139960,0.509973313,0.46629863,13109,0.043674684
8061,91,726,853,0.106682298,0.851113716,635,-0.744431419,CO,Kiowa County,,821,118,677,0.143727162,0.824604141,559,-0.680876979
8063,526,2894,3613,0.145585386,0.800996402,2368,-0.655411016,CO,Kit Carson County,,3525,789,2664,0.223829787,0.755744681,1875,-0.531914894
8065,1600,1264,3175,0.503937008,0.398110236,336,0.105826772,CO,Lake County,,2993,1807,1087,0.603742065,0.363180755,720,0.24056131
8067,15300,12471,30722,0.498014452,0.405930603,2829,0.092083849,CO,La Plata County,,28475,15063,12554,0.528990342,0.440877963,2509,0.088112379
8069,92170,82624,193897,0.475355472,0.426123148,9546,0.049232324,CO,Larimer County,,161823,83103,74603,0.513542574,0.461016048,8500,0.052526526
8071,2614,3656,6693,0.390557299,0.546242343,1042,-0.155685044,CO,Las Animas County,,6532,3282,3105,0.502449479,0.475352113,177,0.027097367
8073,399,1873,2402,0.166111574,0.779766861,1474,-0.613655287,CO,Lincoln County,,2248,537,1663,0.238879004,0.739768683,1126,-0.50088968
8075,1843,7272,9702,0.189960833,0.749536178,5429,-0.559575345,CO,Logan County,,9030,2675,6124,0.296234773,0.678183832,3449,-0.381949059
8077,20958,48129,74876,0.279902773,0.642782734,27171,-0.362879962,CO,Mesa County,,69033,22448,45087,0.325177814,0.65312242,22639,-0.327944606
8079,237,344,652,0.363496933,0.527607362,107,-0.164110429,CO,Mineral County,,650,291,344,0.447692308,0.529230769,53,-0.081538462
8081,874,5293,6510,0.134254992,0.813056836,4419,-0.678801843,CO,Moffat County,,6042,1291,4616,0.21367097,0.763985435,3325,-0.550314465
8083,3920,7771,12706,0.308515662,0.611600819,3851,-0.303085157,CO,Montezuma County,,12232,4486,7372,0.366742969,0.602681491,2886,-0.235938522
8085,5438,14303,21070,0.258092074,0.678832463,8865,-0.420740389,CO,Montrose County,,19054,5852,12789,0.307127112,0.671197649,6937,-0.364070536
8087,3128,8104,11888,0.263122476,0.681695828,4976,-0.418573351,CO,Morgan County,,10478,3761,6461,0.358942546,0.61662531,2700,-0.257682764
8089,1719,2988,5038,0.341206828,0.593092497,1269,-0.251885669,CO,Otero County,,8039,3566,4315,0.443587511,0.536758303,749,-0.093170792
8091,1690,1337,3287,0.514146638,0.406753879,353,0.107392759,CO,Ouray County,,3183,1640,1470,0.515237198,0.461828464,170,0.053408734
8093,3351,6053,10245,0.327086384,0.590824793,2702,-0.263738409,CO,Park County,,9054,3721,5085,0.410978573,0.561630219,1364,-0.150651646
8095,436,1791,2332,0.186963979,0.768010292,1355,-0.581046312,CO,Phillips County,,2265,588,1637,0.259602649,0.722737307,1049,-0.463134658
8097,7239,2522,10387,0.696928853,0.242803504,4717,0.454125349,CO,Pitkin County,,9779,6648,2941,0.679824113,0.300746498,3707,0.379077615
8099,1173,3508,4978,0.235636802,0.704700683,2335,-0.469063881,CO,Prowers County,,4809,1498,3200,0.311499272,0.665419006,1702,-0.353919734
8101,27945,27746,60112,0.46488222,0.461571733,199,0.003310487,CO,Pueblo County,,73306,40624,31023,0.554170191,0.423198647,9601,0.130971544
8103,433,2782,3436,0.126018626,0.809662398,2349,-0.683643772,CO,Rio Blanco County,,3311,561,2677,0.169435216,0.808517064,2116,-0.639081848
8105,1985,3060,5488,0.361698251,0.557580175,1075,-0.195881924,CO,Rio Grande County,,5453,2428,2892,0.44525949,0.530350266,464,-0.085090776
8107,7487,5149,13772,0.543639268,0.373874528,2338,0.16976474,CO,Routt County,,13038,7389,5361,0.566728026,0.411182697,2028,0.155545329
8109,1345,1109,2707,0.496859993,0.409678611,236,0.087181382,CO,Saguache County,,2796,1762,937,0.63018598,0.335121602,825,0.295064378
8111,265,215,506,0.523715415,0.424901186,50,0.098814229,CO,San Juan County,,506,266,212,0.5256917,0.418972332,54,0.106719368
8113,2960,1030,4311,0.686615634,0.238923684,1930,0.447691951,CO,San Miguel County,,4215,2961,1144,0.702491103,0.271411625,1817,0.431079478
8115,267,1015,1364,0.195747801,0.744134897,748,-0.548387097,CO,Sedgwick County,,1337,419,881,0.313388182,0.658937921,462,-0.345549738
8117,9502,5064,16061,0.591619451,0.315297927,4438,0.276321524,CO,Summit County,,15038,9169,5495,0.609722038,0.365407634,3674,0.244314404
8119,3547,9580,14203,0.249735971,0.674505386,6033,-0.424769415,CO,Teller County,,12144,3894,7909,0.320652174,0.651268116,4015,-0.330615942
8121,289,2284,2708,0.106720827,0.843426883,1995,-0.736706056,CO,Washington County,,2567,461,2059,0.179587067,0.802103623,1598,-0.622516556
8123,45869,75882,133790,0.342843262,0.567172434,30013,-0.224329173,CO,Weld County,,112695,47418,62350,0.420764009,0.553263233,14932,-0.132499224
8125,701,3755,4664,0.150300172,0.805102916,3054,-0.654802744,CO,Yuma County,,4481,950,3433,0.212006249,0.766123633,2483,-0.554117385
9001,238723,155457,410279,0.581855274,0.378905574,83266,0.2029497,CT,Fairfield County,,390611,214757,172238,0.549797625,0.440945083,42519,0.108852541
9003,233789,147912,399219,0.585615915,0.370503408,85877,0.215112507,CT,Hartford County,,392485,244314,143648,0.62247984,0.365996153,100666,0.256483687
9005,39836,53376,97434,0.40885112,0.547816984,13540,-0.138965864,CT,Litchfield County,,92404,43823,47207,0.474254361,0.510876153,3384,-0.036621791
9007,45306,38847,88402,0.512499717,0.439435759,6459,0.073063958,CT,Middlesex County,,83447,47851,34533,0.573429842,0.413831534,13318,0.159598308
9009,203601,158373,375909,0.541623106,0.421306752,45228,0.120316353,CT,New Haven County,,371783,230040,137942,0.618748033,0.371028261,92098,0.247719772
9011,62951,54574,124527,0.505520891,0.438250339,8377,0.067270552,CT,New London County,,114043,66510,45715,0.583201073,0.400857571,20795,0.182343502
9013,38450,33989,77069,0.49890358,0.441020384,4461,0.057883196,CT,Tolland County,,70780,39283,30391,0.555001413,0.429372704,8892,0.125628709
9015,21776,25738,50703,0.42948149,0.507622823,3962,-0.078141333,CT,Windham County,,46634,25953,19758,0.556525282,0.423682292,6195,0.13284299
10001,33347,36989,74253,0.4490997,0.498148223,3642,-0.049048523,DE,Kent County,,68669,35525,32134,0.51733679,0.467954972,3391,0.049381817
10003,162905,85507,261468,0.623039913,0.327026634,77398,0.296013279,DE,New Castle County,,251960,167051,81226,0.663006033,0.322376568,85825,0.340629465
10005,39329,62607,105814,0.371680496,0.591670289,23278,-0.219989793,DE,Sussex County,,93215,39971,52116,0.428804377,0.559094566,12145,-0.130290189
11001,260223,11553,280272,0.928465919,0.041220671,248670,0.887245247,DC,District of Columbia,,243348,222332,17337,0.913638082,0.071243651,204995,0.842394431
12001,75370,46584,127827,0.58962504,0.36443005,28786,0.22519499,FL,Alachua County,,120318,69634,48765,0.578749647,0.405300952,20869,0.173448694
12003,2112,10294,12634,0.167167959,0.814785499,8182,-0.64761754,FL,Baker County,,11366,2310,8974,0.203237727,0.789547774,6664,-0.586310048
12005,21689,62010,87151,0.248866909,0.711523677,40321,-0.462656768,FL,Bay County,,79834,22037,56863,0.276035273,0.712265451,34826,-0.436230178
12007,2924,8913,12098,0.241692842,0.736733344,5989,-0.495040503,FL,Bradford County,,11631,3324,8216,0.28578798,0.706388101,4892,-0.42060012
12009,119525,181620,314337,0.380244769,0.577787534,62095,-0.197542765,FL,Brevard County,,285504,122972,159270,0.430719009,0.557855582,36298,-0.127136573
12011,546956,258521,822837,0.664719744,0.314182517,288435,0.350537227,FL,Broward County,,755166,507430,243732,0.671944976,0.322752878,263698,0.349192098
12013,1236,4647,6067,0.20372507,0.765946926,3411,-0.562221856,FL,Calhoun County,,6152,1664,4366,0.270481144,0.709687906,2702,-0.439206762
12015,33421,60196,96323,0.346968014,0.624939007,26775,-0.277970993,FL,Charlotte County,,84664,35896,47988,0.423981858,0.566805254,12092,-0.142823396
12017,22765,54377,79590,0.286028396,0.683213972,31612,-0.397185576,FL,Citrus County,,73923,28453,44657,0.384900505,0.604101565,16204,-0.219201061
12019,27768,74898,106363,0.261068229,0.704173444,47130,-0.443105215,FL,Clay County,,96549,25745,69996,0.266652166,0.724979026,44251,-0.45832686
12021,60941,105297,170505,0.357414739,0.617559602,44356,-0.260144864,FL,Collier County,,149080,51678,96508,0.346646096,0.647357124,44830,-0.300711028
12023,7599,20359,28696,0.264810427,0.709471703,12760,-0.444661277,FL,Columbia County,,27163,8462,18429,0.311526709,0.678459669,9967,-0.36693296
12027,3761,6744,10761,0.349502834,0.626707555,2983,-0.277204721,FL,DeSoto County,,9863,4174,5587,0.42319781,0.566460509,1413,-0.143262699
12029,1270,5822,7202,0.176339906,0.808386559,4552,-0.632046654,FL,Dixie County,,6941,1798,5052,0.259040484,0.727849013,3254,-0.468808529
12031,203627,210061,428734,0.474949502,0.489956477,6434,-0.015006974,FL,Duval County,,411702,196657,211553,0.477668313,0.513849823,14896,-0.03618151
12033,57114,88370,151609,0.37671906,0.582880964,31256,-0.206161903,FL,Escambia County,,148430,58154,88671,0.391794112,0.59739271,30517,-0.205598599
12035,21985,33804,57413,0.382927212,0.588786512,11819,-0.2058593,FL,Flagler County,,50589,23204,26966,0.458676787,0.53304078,3762,-0.074363992
12037,1738,4119,6003,0.289521906,0.686156922,2381,-0.396635016,FL,Franklin County,,5474,1845,3570,0.337047863,0.652173913,1725,-0.31512605
12039,14994,6721,22079,0.679106844,0.304406902,8273,0.374699941,FL,Gadsden County,,22495,15768,6628,0.700955768,0.294643254,9140,0.406312514
12041,1457,6740,8418,0.173081492,0.800665241,5283,-0.627583749,FL,Gilchrist County,,7908,1885,5917,0.238366211,0.748229641,4032,-0.509863429
12043,1271,2996,4355,0.29184845,0.687944891,1725,-0.396096441,FL,Glades County,,3989,1603,2344,0.401855102,0.587615944,741,-0.185760842
12045,1715,5320,7279,0.235609287,0.730869625,3605,-0.495260338,FL,Gulf County,,7107,2013,4995,0.283241874,0.702828198,2982,-0.419586323
12047,1899,3439,5451,0.348376445,0.630893414,1540,-0.282516969,FL,Hamilton County,,5404,2226,3137,0.411917098,0.580495929,911,-0.16857883
12049,2147,5238,7577,0.283357529,0.691302626,3091,-0.407945097,FL,Hardee County,,7222,2461,4694,0.340764331,0.64995846,2233,-0.309194129
12051,4610,6192,11106,0.415090942,0.557536467,1582,-0.142445525,FL,Hendry County,,10185,4751,5355,0.466470299,0.525773196,604,-0.059302896
12053,31818,59029,93878,0.338929249,0.628784167,27211,-0.289854918,FL,Hernando County,,83593,37791,44906,0.452083308,0.537198091,7115,-0.085114782
12055,14901,29509,45589,0.326855162,0.647283336,14608,-0.320428173,FL,Highlands County,,42440,16147,25912,0.380466541,0.610556079,9765,-0.230089538
12057,306422,265928,595072,0.514932647,0.446883738,40494,0.068048908,FL,Hillsborough County,,541503,286158,249904,0.528451366,0.461500675,36254,0.066950691
12059,852,7476,8506,0.10016459,0.878909005,6624,-0.778744416,FL,Holmes County,,8274,1264,6919,0.152767706,0.836233986,5655,-0.68346628
12061,28997,48564,79897,0.362929772,0.607832584,19567,-0.244902812,FL,Indian River County,,71445,27483,43441,0.384673525,0.608034152,15958,-0.223360627
12063,6383,14231,20997,0.303995809,0.67776349,7848,-0.373767681,FL,Jackson County,,20940,7342,13417,0.350620821,0.640735435,6075,-0.290114613
12065,3537,3930,7641,0.462897527,0.514330585,393,-0.051433059,FL,Jefferson County,,7808,3945,3808,0.505251025,0.487704918,137,0.017546107
12067,515,2795,3375,0.152592593,0.828148148,2280,-0.675555556,FL,Lafayette County,,3399,687,2668,0.20211827,0.784936746,1981,-0.582818476
12069,62597,101888,169898,0.36843871,0.599700997,39291,-0.231262287,FL,Lake County,,150796,61790,87637,0.40975888,0.58116263,25847,-0.171403751
12071,124725,191141,325797,0.382830413,0.586687416,66416,-0.203857003,FL,Lee County,,266034,110080,154112,0.413781697,0.579294376,44032,-0.165512679
12073,91936,53777,151925,0.605140694,0.353970709,38159,0.251169985,FL,Leon County,,148335,90863,55806,0.612552668,0.376215998,35057,0.23633667
12075,5091,13758,19367,0.26286983,0.710383642,8667,-0.447513812,FL,Levy County,,18396,6118,12052,0.332572298,0.655142422,5934,-0.322570124
12077,651,2542,3295,0.197572079,0.771471927,1891,-0.573899848,FL,Liberty County,,3284,942,2301,0.286845311,0.700669915,1359,-0.413824604
12079,3526,4849,8503,0.414677173,0.570269317,1323,-0.155592144,FL,Madison County,,8712,4174,4474,0.479109275,0.513544536,300,-0.034435262
12081,71066,101681,178521,0.398082018,0.569574448,30615,-0.171492429,FL,Manatee County,,153451,66476,85616,0.433206691,0.557937061,19140,-0.12473037
12083,61958,107710,174485,0.355090695,0.617302347,45752,-0.262211651,FL,Marion County,,161368,66823,93036,0.414103168,0.576545536,26213,-0.162442368
12085,30158,53182,85741,0.35173371,0.620263351,23024,-0.268529642,FL,Martin County,,78860,30097,48180,0.381651027,0.610956125,18083,-0.229305098
12086,623006,333666,978670,0.636584344,0.340938212,289340,0.295646132,FL,Miami-Dade County,,877245,540776,332602,0.616448085,0.379143797,208174,0.237304288
12087,18949,21885,42434,0.446552293,0.515742094,2936,-0.069189801,FL,Monroe County,,39045,19392,19234,0.496657703,0.49261109,158,0.004046613
12089,10849,34221,46537,0.23312633,0.735350366,23372,-0.502224037,FL,Nassau County,,40523,10249,29926,0.252918096,0.738494188,19677,-0.485576093
12091,23711,71788,100657,0.235562355,0.713194313,48077,-0.477631958,FL,Okaloosa County,,94739,23390,70143,0.246888821,0.740381469,46753,-0.493492648
12093,3953,9342,13632,0.28997946,0.685299296,5389,-0.395319836,FL,Okeechobee County,,12321,4856,7325,0.394123854,0.594513432,2469,-0.200389579
12095,329579,195091,545800,0.603845731,0.357440454,134488,0.246405277,FL,Orange County,,467385,274227,189057,0.586726147,0.404499503,85170,0.182226644
12097,85287,50252,139981,0.609275545,0.358991577,35035,0.250283967,FL,Osceola County,,108647,67201,40581,0.618526052,0.373512384,26620,0.245013668
12099,371411,270762,657235,0.565111414,0.411971365,100649,0.153140049,FL,Palm Beach County,,600341,349418,247257,0.582032545,0.411860926,102161,0.170171619
12101,89998,141943,240814,0.373724119,0.589430017,51945,-0.215705897,FL,Pasco County,,213358,98148,112335,0.460015561,0.526509435,14187,-0.066493874
12103,233327,238746,491520,0.474704997,0.48572998,5419,-0.011024984,FL,Pinellas County,,457484,238966,213192,0.522348323,0.46600974,25774,0.056338582
12105,117182,157216,283828,0.41286272,0.553912933,40034,-0.141050214,FL,Polk County,,248658,114610,131566,0.460914187,0.529104232,16956,-0.068190044
12107,9920,21873,32652,0.303809874,0.669882396,11953,-0.366072522,FL,Putnam County,,31323,11666,19326,0.372441976,0.61699071,7660,-0.244548734
12109,43037,88633,136392,0.315539035,0.649840167,45596,-0.334301132,FL,St. Johns County,,114733,35155,78490,0.306407049,0.684110064,43335,-0.377703015
12111,66812,70248,140731,0.4747497,0.499165074,3436,-0.024415374,FL,St. Lucie County,,123026,65869,56202,0.53540715,0.456830264,9667,0.078576886
12113,18398,65126,87432,0.210426389,0.744876018,46728,-0.534449629,FL,Santa Rosa County,,76816,17757,58169,0.231162779,0.757251094,40412,-0.526088315
12115,97676,124098,228509,0.427449247,0.543077078,26422,-0.115627831,FL,Sarasota County,,207434,95089,110489,0.458406047,0.532646529,15400,-0.074240481
12117,105611,109265,224377,0.470685498,0.48697059,3654,-0.016285092,FL,Seminole County,,208605,96435,109939,0.46228518,0.527019966,13504,-0.064734786
12119,22631,52722,76649,0.295254994,0.687836762,30091,-0.392581769,FL,Sumter County,,60471,19519,40644,0.322782822,0.672123828,21125,-0.349341006
12121,3955,14281,18675,0.211780455,0.764712182,10326,-0.552931727,FL,Suwannee County,,17627,4749,12672,0.269416236,0.718897146,7923,-0.44948091
12123,2149,6923,9279,0.231598233,0.746093329,4774,-0.514495096,FL,Taylor County,,9117,2761,6249,0.302840847,0.685422836,3488,-0.38258199
12125,1014,4567,5693,0.178113473,0.802213244,3553,-0.624099772,FL,Union County,,5393,1339,3980,0.248284814,0.737993696,2641,-0.489708882
12127,108793,142763,260304,0.41794594,0.5484472,33970,-0.13050126,FL,Volusia County,,234483,114716,117473,0.489229496,0.500987278,2757,-0.011757782
12129,4348,10507,15344,0.283368092,0.684762774,6159,-0.401394682,FL,Wakulla County,,14656,5173,9288,0.352961245,0.633733624,4115,-0.28077238
12131,6861,25695,33559,0.204445901,0.765666438,18834,-0.561220537,FL,Walton County,,28480,6665,21483,0.234023876,0.75431882,14818,-0.520294944
12133,2261,8630,11144,0.202889447,0.774407753,6369,-0.571518306,FL,Washington County,,10998,2820,8037,0.256410256,0.730769231,5217,-0.474358974
13001,1434,5492,7003,0.204769385,0.784235328,4058,-0.579465943,GA,Appling County,,7079,1756,5231,0.248057635,0.738946179,3475,-0.490888544
13003,696,1873,2604,0.267281106,0.719278034,1177,-0.451996928,GA,Atkinson County,,2902,930,1938,0.320468642,0.6678153,1008,-0.347346657
13005,607,3356,4010,0.151371571,0.836907731,2749,-0.68553616,GA,Bacon County,,3929,791,3092,0.201323492,0.786968694,2301,-0.585645202
13007,650,775,1440,0.451388889,0.538194444,125,-0.086805556,GA,Baker County,,1584,790,784,0.498737374,0.494949495,6,0.003787879
13009,7965,7691,16075,0.495489891,0.47844479,274,0.017045101,GA,Baldwin County,,16214,8469,7585,0.522326385,0.4678056,884,0.054520785
13011,684,6130,6946,0.098473942,0.882522315,5446,-0.784048373,GA,Banks County,,6191,779,5353,0.125827815,0.864642223,4574,-0.738814408
13013,6580,21105,28828,0.228250312,0.732100735,14525,-0.503850423,GA,Barrow County,,25171,6019,18719,0.239124389,0.743673275,12700,-0.504548886
13015,8204,29879,39263,0.208949902,0.760996358,21675,-0.552046456,GA,Bartow County,,35738,8383,26847,0.234568247,0.751217192,18464,-0.516648945
13017,2098,3734,5923,0.354212392,0.630423772,1636,-0.276211379,GA,Ben Hill County,,5947,2508,3395,0.42172524,0.570876072,887,-0.149150832
13019,1041,5408,6563,0.158616486,0.824013409,4367,-0.665396922,GA,Berrien County,,6187,1268,4837,0.204945854,0.78180055,3569,-0.576854695
13021,34383,22589,58327,0.589486859,0.387282048,11794,0.202204811,GA,Bibb County,,64625,38538,25606,0.596332689,0.396224371,12932,0.200108317
13023,1094,3717,4934,0.221726794,0.753344143,2623,-0.531617349,GA,Bleckley County,,4903,1266,3586,0.25820926,0.731388946,2320,-0.473179686
13025,619,5561,6285,0.098488465,0.884805091,4942,-0.786316627,GA,Brantley County,,6001,939,4963,0.156473921,0.827028829,4024,-0.670554908
13027,2504,3679,6268,0.39948947,0.586949585,1175,-0.187460115,GA,Brooks County,,6671,3101,3522,0.464847849,0.527956828,421,-0.063108979
13029,4010,10513,15063,0.266215229,0.697935338,6503,-0.431720109,GA,Bryan County,,13403,3695,9537,0.275684548,0.711557114,5842,-0.435872566
13031,8812,14476,24151,0.36487102,0.59939547,5664,-0.23452445,GA,Bulloch County,,24032,9572,14159,0.398302264,0.58917277,4587,-0.190870506
13033,4730,4491,9350,0.505882353,0.480320856,239,0.025561497,GA,Burke County,,9773,5403,4298,0.552849688,0.439783076,1105,0.113066612
13035,2566,6717,9477,0.270760789,0.708768598,4151,-0.438007808,GA,Butts County,,9372,2966,6306,0.316474605,0.672855314,3340,-0.356380708
13037,1178,829,2023,0.58230351,0.409787444,349,0.172516065,GA,Calhoun County,,2187,1297,883,0.59304984,0.403749428,414,0.189300412
13039,5914,12287,18825,0.314156707,0.652695883,6373,-0.338539177,GA,Camden County,,17938,6358,11318,0.354443082,0.630951054,4960,-0.276507972
13043,1023,2661,3757,0.272291722,0.708277881,1638,-0.435986159,GA,Candler County,,3526,1155,2344,0.327566648,0.66477595,1189,-0.337209302
13045,12422,29983,43744,0.283970373,0.685419715,17561,-0.401449342,GA,Carroll County,,41445,12635,28249,0.304861865,0.681602123,15614,-0.376740258
13047,4769,20860,26510,0.179894379,0.786872878,16091,-0.606978499,GA,Catoosa County,,23639,5357,17848,0.226617031,0.755023478,12491,-0.528406447
13049,1004,2950,4008,0.250499002,0.736027944,1946,-0.485528942,GA,Charlton County,,3763,1197,2527,0.318097263,0.671538666,1330,-0.353441403
13051,58998,43649,106013,0.556516654,0.411732523,15349,0.14478413,GA,Chatham County,,108267,60077,47083,0.554896691,0.434878587,12994,0.120018103
13053,593,746,1384,0.428468208,0.539017341,153,-0.110549133,GA,Chattahoochee County,,1483,726,732,0.489548213,0.493594066,6,-0.004045853
13055,1612,6457,8246,0.195488722,0.783046325,4845,-0.587557604,GA,Chattooga County,,7791,2220,5434,0.284944166,0.697471441,3214,-0.412527275
13057,25203,80611,110825,0.227412587,0.727371983,55408,-0.499959395,GA,Cherokee County,,98041,19813,76473,0.202088922,0.780010404,56660,-0.577921482
13059,29514,12691,44221,0.667420456,0.286990344,16823,0.380430112,GA,Clarke County,,40138,25386,13804,0.632467985,0.343913498,11582,0.288554487
13061,697,566,1271,0.548387097,0.445318647,131,0.10306845,GA,Clay County,,1402,862,537,0.614835949,0.383024251,325,0.231811698
13063,75908,11740,89236,0.850643238,0.131561253,64168,0.719081985,GA,Clayton County,,96020,81439,14158,0.84814622,0.147448448,67281,0.700697771
13065,685,1724,2443,0.280392959,0.705689726,1039,-0.425296766,GA,Clinch County,,2472,852,1598,0.344660194,0.646440129,746,-0.301779935
13067,159416,152602,326424,0.488370953,0.467496263,6814,0.020874691,GA,Cobb County,,308989,132526,171464,0.428902,0.554919431,38938,-0.126017431
13069,4090,9575,13896,0.294329303,0.689047208,5485,-0.394717904,GA,Coffee County,,14434,5048,9242,0.349729805,0.640293751,4194,-0.290563946
13071,3460,9892,13592,0.254561507,0.727781048,6432,-0.473219541,GA,Colquitt County,,13319,3971,9240,0.298145506,0.693745777,5269,-0.39560027
13073,18863,43060,64190,0.293861972,0.670821,24197,-0.376959028,GA,Columbia County,,58842,16420,41724,0.279052378,0.709085347,25304,-0.43003297
13075,1752,4175,6038,0.290162305,0.691454124,2423,-0.401291818,GA,Cook County,,6027,2042,3934,0.338808694,0.652729384,1892,-0.31392069
13077,16572,42513,61315,0.270276441,0.693353992,25941,-0.42307755,GA,Coweta County,,55512,15156,39633,0.273022049,0.71395374,24477,-0.44093169
13079,1419,3632,5157,0.275159977,0.704285437,2213,-0.429125461,GA,Crawford County,,5123,1699,3366,0.331641616,0.657036892,1667,-0.325395276
13081,2835,4539,7500,0.378,0.6052,1704,-0.2272,GA,Crisp County,,7386,3160,4179,0.427836447,0.565800162,1019,-0.137963715
13083,965,5047,6238,0.154697018,0.809073421,4082,-0.654376403,GA,Dade County,,5997,1404,4458,0.234117059,0.743371686,3054,-0.509254627
13085,1444,9880,11680,0.123630137,0.845890411,8436,-0.722260274,GA,Dawson County,,10234,1241,8843,0.121262458,0.864080516,7602,-0.742818057
13087,4104,6009,10238,0.400859543,0.586931041,1905,-0.186071498,GA,Decatur County,,10465,4580,5816,0.437649307,0.555757286,1236,-0.118107979
13089,239131,47531,295871,0.808227234,0.160647715,191600,0.647579519,GA,DeKalb County,,305299,237704,64308,0.7785941,0.210639406,173396,0.567954694
13091,1836,5021,6995,0.262473195,0.717798427,3185,-0.455325232,GA,Dodge County,,7731,2440,5214,0.315612469,0.674427629,2774,-0.35881516
13093,1860,1941,3836,0.484880083,0.505995829,81,-0.021115746,GA,Dooly County,,4289,2278,1983,0.531126137,0.462345535,295,0.068780602
13095,23224,10227,33925,0.684568902,0.301459101,12997,0.383109801,GA,Dougherty County,,37822,26209,11441,0.69295648,0.302495902,14768,0.390460578
13097,30971,24803,57365,0.539893663,0.432371655,6168,0.107522008,GA,Douglas County,,55201,28410,26226,0.514664589,0.475100089,2184,0.039564501
13099,2165,2552,4782,0.45273944,0.533667921,387,-0.080928482,GA,Early County,,5349,2762,2556,0.516358198,0.477846326,206,0.038511871
13101,156,1006,1175,0.132765957,0.856170213,850,-0.723404255,GA,Echols County,,1102,173,917,0.156987296,0.832123412,744,-0.675136116
13103,4851,17865,23395,0.207351998,0.763624706,13014,-0.556272708,GA,Effingham County,,20779,4941,15591,0.237788151,0.750324847,10650,-0.512536696
13105,2507,5269,7912,0.316860465,0.665950455,2762,-0.34908999,GA,Elbert County,,8139,3179,4857,0.390588524,0.596756358,1678,-0.206167834
13107,2433,5330,7838,0.310410819,0.680020413,2897,-0.369609594,GA,Emanuel County,,8060,2919,5086,0.362158809,0.63101737,2167,-0.268858561
13109,1130,2404,3602,0.313714603,0.667406996,1274,-0.353692393,GA,Evans County,,3560,1266,2267,0.355617978,0.636797753,1001,-0.281179775
13111,1920,9622,11764,0.163209793,0.817919075,7702,-0.654709283,GA,Fannin County,,10007,2027,7853,0.202558209,0.784750675,5826,-0.582192465
13113,23255,35034,60387,0.385099442,0.580157981,11779,-0.195058539,GA,Fayette County,,58473,19703,38046,0.336958938,0.650659279,18343,-0.31370034
13115,9127,24045,34250,0.266481752,0.702043796,14918,-0.435562044,GA,Floyd County,,32685,9595,22636,0.293559737,0.692550099,13041,-0.398990363
13117,23427,69801,97314,0.240736174,0.717276034,46374,-0.476539861,GA,Forsyth County,,81598,14544,65853,0.178239663,0.807041839,51309,-0.628802177
13119,1243,7054,8474,0.146683975,0.832428605,5811,-0.685744631,GA,Franklin County,,7757,1499,6112,0.193244811,0.787933479,4613,-0.594688668
13121,281875,110372,407173,0.692273309,0.271069054,171503,0.421204255,GA,Fulton County,,386845,248479,133837,0.64232186,0.345970608,114642,0.296351252
13123,1955,10465,12713,0.153779596,0.82317313,8510,-0.669393534,GA,Gilmer County,,11008,1955,8920,0.17759811,0.810319767,6965,-0.632721657
13125,138,1235,1390,0.099280576,0.888489209,1097,-0.789208633,GA,Glascock County,,1333,176,1135,0.132033008,0.851462866,959,-0.719429857
13127,11738,21482,34041,0.344819482,0.631062542,9744,-0.28624306,GA,Glynn County,,33054,11922,20853,0.36068252,0.630876747,8931,-0.270194228
13129,3176,15171,18850,0.168488064,0.804827586,11995,-0.636339523,GA,Gordon County,,16857,3436,13174,0.203832236,0.781515098,9738,-0.577682862
13131,3005,6047,9187,0.327092631,0.658212692,3042,-0.331120061,GA,Grady County,,9391,3419,5922,0.364071984,0.63060377,2503,-0.266531786
13133,3194,5488,8831,0.361680444,0.621447175,2294,-0.259766731,GA,Greene County,,8313,3195,5067,0.384337784,0.609527246,1872,-0.225189462
13135,165063,146463,323931,0.509562222,0.452142586,18600,0.057419636,GA,Gwinnett County,,295560,131879,159563,0.446200433,0.539866694,27684,-0.093666261
13137,2483,13184,16128,0.153955853,0.817460317,10701,-0.663504464,GA,Habersham County,,14600,2297,12148,0.157328767,0.832054795,9851,-0.674726027
13139,16153,51681,70133,0.230319536,0.73689989,35528,-0.506580354,GA,Hall County,,59241,12489,45918,0.210816833,0.775105079,33429,-0.564288246
13141,2695,841,3572,0.754479283,0.235442329,1854,0.519036954,GA,Hancock County,,4076,3301,764,0.80986261,0.187438665,2537,0.622423945
13143,1474,9579,11317,0.130246532,0.846425731,8105,-0.716179199,GA,Haralson County,,10362,1787,8439,0.172457055,0.814418066,6652,-0.641961011
13145,4082,11931,16392,0.249023914,0.727855051,7849,-0.478831137,GA,Harris County,,15479,4141,11193,0.267523742,0.723108728,7052,-0.455584986
13147,2583,7285,10077,0.256326288,0.722933413,4702,-0.466607125,GA,Hart County,,9501,2869,6516,0.301968214,0.685822545,3647,-0.383854331
13149,743,3370,4206,0.176652401,0.801236329,2627,-0.624583928,GA,Heard County,,4162,947,3155,0.227534839,0.758049015,2208,-0.530514176
13151,49902,45641,98037,0.509011904,0.465548721,4261,0.043463182,GA,Henry County,,90469,43374,46299,0.479434945,0.511766461,2925,-0.032331517
13153,22460,35351,59559,0.377105055,0.593545896,12891,-0.21644084,GA,Houston County,,57912,22643,34631,0.390989778,0.597993507,11988,-0.20700373
13155,890,2711,3659,0.243235857,0.740912818,1821,-0.497676961,GA,Irwin County,,3683,1134,2519,0.307901168,0.683953299,1385,-0.376052131
13157,4469,21754,27057,0.165169827,0.804006357,17285,-0.63883653,GA,Jackson County,,23670,4236,19122,0.17896071,0.807858048,14886,-0.628897338
13159,1544,4353,6016,0.256648936,0.723570479,2809,-0.466921543,GA,Jasper County,,6010,1839,4121,0.305990017,0.685690516,2282,-0.379700499
13161,901,4102,5089,0.177048536,0.80605227,3201,-0.629003734,GA,Jeff Davis County,,5330,1271,3994,0.238461538,0.74934334,2723,-0.510881801
13163,3809,3057,6934,0.549322181,0.44087107,752,0.10845111,GA,Jefferson County,,7268,4238,2992,0.583104018,0.411667584,1246,0.171436434
13165,1108,1892,3034,0.365194463,0.623599209,784,-0.258404746,GA,Jenkins County,,3386,1487,1884,0.439161252,0.556408742,397,-0.11724749
13167,1136,2519,3682,0.308527974,0.684139055,1383,-0.375611081,GA,Johnson County,,3772,1305,2440,0.345970308,0.646871686,1135,-0.300901379
13169,3960,8304,12524,0.31619291,0.66304695,4344,-0.34685404,GA,Jones County,,12099,4272,7740,0.353087032,0.639722291,3468,-0.286635259
13171,2267,5183,7575,0.299273927,0.684224422,2916,-0.384950495,GA,Lamar County,,7589,2602,4896,0.342864673,0.645144288,2294,-0.302279615
13173,805,1984,2861,0.28137015,0.693463824,1179,-0.412093674,GA,Lanier County,,2958,1108,1812,0.374577417,0.612576065,704,-0.237998648
13175,6737,12401,19448,0.346410942,0.637649116,5664,-0.291238174,GA,Laurens County,,19591,7508,11947,0.383237201,0.609820836,4439,-0.226583635
13177,3166,10641,14106,0.224443499,0.754359847,7475,-0.529916348,GA,Lee County,,13607,3187,10310,0.234217682,0.757698244,7123,-0.523480561
13179,9531,6125,16082,0.592650168,0.380860589,3406,0.211789578,GA,Liberty County,,16132,10427,5558,0.646355071,0.344532606,4869,0.301822465
13181,1271,2759,4100,0.31,0.672926829,1488,-0.362926829,GA,Lincoln County,,4425,1586,2806,0.358418079,0.634124294,1220,-0.275706215
13183,1356,2623,4109,0.330007301,0.638354831,1267,-0.30834753,GA,Long County,,3786,1434,2300,0.378763867,0.607501321,866,-0.228737454
13185,14614,21308,36813,0.396979328,0.578817266,6694,-0.181837938,GA,Lowndes County,,38610,17118,21176,0.443356643,0.548458948,4058,-0.105102305
13187,2216,9613,12324,0.179811749,0.78002272,7397,-0.60021097,GA,Lumpkin County,,10878,2049,8633,0.188361831,0.793620151,6584,-0.60525832
13189,3699,5432,9268,0.399115235,0.586102719,1733,-0.186987484,GA,McDuffie County,,9585,4041,5475,0.421596244,0.571205008,1434,-0.149608764
13191,2298,3482,5893,0.389954183,0.590870524,1184,-0.200916341,GA,McIntosh County,,6333,2860,3405,0.451602716,0.537659877,545,-0.086057161
13193,2705,1540,4287,0.630977373,0.359225566,1165,0.271751808,GA,Macon County,,4781,3211,1545,0.671616817,0.323154152,1666,0.348462665
13195,2423,9195,11945,0.202846379,0.76977815,6772,-0.566931771,GA,Madison County,,11079,2486,8441,0.224388483,0.761891867,5955,-0.537503385
13197,1213,1921,3183,0.381087025,0.603518693,708,-0.222431668,GA,Marion County,,3167,1411,1731,0.445532049,0.546574045,320,-0.101041996
13199,3800,5216,9181,0.413898268,0.568129833,1416,-0.154231565,GA,Meriwether County,,9259,4328,4855,0.467437088,0.524354682,527,-0.056917594
13201,622,1888,2540,0.24488189,0.743307087,1266,-0.498425197,GA,Miller County,,2770,848,1904,0.306137184,0.687364621,1056,-0.381227437
13205,3492,4272,7857,0.444444444,0.543718977,780,-0.099274532,GA,Mitchell County,,8273,4081,4153,0.49329143,0.50199444,72,-0.00870301
13207,3570,8821,12675,0.281656805,0.695936884,5251,-0.414280079,GA,Monroe County,,12259,3779,8352,0.308263317,0.681295375,4573,-0.373032058
13209,847,2668,3560,0.237921348,0.749438202,1821,-0.511516854,GA,Montgomery County,,3831,1135,2662,0.296267293,0.694857739,1527,-0.398590446
13211,2658,6559,9435,0.281717011,0.69517753,3901,-0.413460519,GA,Morgan County,,9016,2751,6178,0.305124224,0.685226264,3427,-0.380102041
13213,1799,10340,12422,0.1448237,0.832394139,8541,-0.68757044,GA,Murray County,,11209,2542,8439,0.22678205,0.752877152,5897,-0.526095102
13215,39602,26901,68320,0.579654567,0.39375,12701,0.185904567,GA,Muscogee County,,70410,42458,27469,0.603010936,0.390129243,14989,0.212881693
13217,21936,20907,43787,0.500970608,0.477470482,1029,0.023500126,GA,Newton County,,43216,21844,20979,0.50546094,0.485445205,865,0.020015735
13219,5253,12885,19030,0.276037835,0.677088807,7632,-0.401050972,GA,Oconee County,,16643,4140,12222,0.24875323,0.734362795,8082,-0.485609566
13221,1829,4622,6650,0.275037594,0.695037594,2793,-0.42,GA,Oglethorpe County,,6258,1913,4250,0.305688718,0.679130713,2337,-0.373441994
13223,18004,44646,64601,0.278695376,0.691103853,26642,-0.412408477,GA,Paulding County,,57254,15779,40771,0.275596465,0.712107451,24992,-0.436510986
13225,5083,5405,10699,0.47509113,0.505187401,322,-0.030096271,GA,Peach County,,11499,6141,5280,0.534046439,0.459170363,861,0.074876076
13227,1977,11651,13982,0.141396081,0.833285653,9674,-0.691889572,GA,Pickens County,,12673,1975,10547,0.155843131,0.832241774,8572,-0.676398643
13229,903,6301,7297,0.123749486,0.86350555,5398,-0.739756064,GA,Pierce County,,6845,1124,5666,0.164207451,0.827757487,4542,-0.663550037
13231,1239,7273,8675,0.142824207,0.838386167,6034,-0.69556196,GA,Pike County,,8099,1355,6660,0.167304606,0.822323744,5305,-0.655019138
13233,2863,11006,14158,0.202217827,0.777369685,8143,-0.575151858,GA,Polk County,,13580,3608,9798,0.265684831,0.721502209,6190,-0.455817378
13235,1104,2436,3598,0.306837132,0.677042802,1332,-0.37020567,GA,Pulaski County,,3681,1219,2444,0.331160011,0.663950014,1225,-0.332790003
13237,2745,6516,9431,0.291061393,0.690912947,3771,-0.399851553,GA,Putnam County,,9205,2917,6210,0.316892993,0.674633351,3293,-0.357740359
13239,461,575,1044,0.441570881,0.550766284,114,-0.109195402,GA,Quitman County,,1128,612,510,0.542553191,0.45212766,102,0.090425532
13241,1443,6287,7949,0.181532268,0.790917096,4844,-0.609384828,GA,Rabun County,,7438,1558,5753,0.20946491,0.773460608,4195,-0.563995698
13243,1597,1270,2895,0.55164076,0.438687392,327,0.112953368,GA,Randolph County,,3015,1749,1249,0.580099502,0.414262023,500,0.165837479
13245,48707,24441,74952,0.649842566,0.326088697,24266,0.323753869,GA,Richmond County,,78865,52461,25821,0.665200025,0.327407595,26640,0.33779243
13247,23206,13463,37589,0.617361462,0.358163292,9743,0.25919817,GA,Rockdale County,,37879,21878,15671,0.577575966,0.413712083,6207,0.163863882
13249,401,1472,1909,0.210057622,0.771084337,1071,-0.561026716,GA,Schley County,,1748,448,1286,0.256292906,0.735697941,838,-0.479405034
13251,2300,3305,5699,0.403579575,0.579926303,1005,-0.176346727,GA,Screven County,,6093,2769,3285,0.454455933,0.539143279,516,-0.084687346
13253,1186,2343,3577,0.331562762,0.655018172,1157,-0.32345541,GA,Seminole County,,3765,1475,2244,0.391766268,0.596015936,769,-0.204249668
13255,9347,15636,25940,0.360331534,0.602775636,6289,-0.242444102,GA,Spalding County,,25057,9884,14901,0.39446063,0.59468412,5017,-0.20022349
13257,1835,7682,9760,0.188012295,0.787090164,5847,-0.599077869,GA,Stephens County,,9467,2123,7207,0.224252667,0.761276011,5084,-0.537023344
13259,1220,805,2053,0.594252314,0.392109109,415,0.202143205,GA,Stewart County,,2055,1307,740,0.636009732,0.360097324,567,0.275912409
13261,5520,5275,10973,0.503052948,0.480725417,245,0.022327531,GA,Sumter County,,11820,6370,5372,0.53891709,0.454483926,998,0.084433164
13263,2001,1196,3243,0.617021277,0.368794326,805,0.24822695,GA,Talbot County,,3490,2264,1202,0.648710602,0.344412607,1062,0.304297994
13265,545,349,897,0.607580825,0.389074693,196,0.218506132,GA,Taliaferro County,,961,636,321,0.661810614,0.334027055,315,0.327783559
13267,1678,5092,6879,0.243930804,0.74022387,3414,-0.496293066,GA,Tattnall County,,6658,1894,4702,0.284469811,0.706218084,2808,-0.421748273
13269,1295,2062,3402,0.380658436,0.606114051,767,-0.225455614,GA,Taylor County,,3537,1571,1948,0.444161719,0.550749223,377,-0.106587504
13271,1313,2449,3794,0.346072746,0.645492884,1136,-0.299420137,GA,Telfair County,,4334,1804,2479,0.416243655,0.571988925,675,-0.15574527
13273,2267,1872,4179,0.542474276,0.447954056,395,0.09452022,GA,Terrell County,,4398,2544,1834,0.578444748,0.417007731,710,0.161437017
13275,7138,11225,18730,0.38109984,0.599305926,4087,-0.218206086,GA,Thomas County,,18943,7651,11153,0.403895898,0.588766299,3502,-0.184870401
13277,3892,8680,12796,0.304157549,0.67833698,4788,-0.374179431,GA,Tift County,,13893,4640,9171,0.333981142,0.660116605,4531,-0.326135464
13279,2338,6612,9108,0.256697409,0.725955204,4274,-0.469257795,GA,Toombs County,,9333,2740,6519,0.293581914,0.698489232,3779,-0.404907318
13281,1206,5377,6726,0.179304193,0.799435028,4171,-0.620130836,GA,Towns County,,6159,1265,4834,0.205390485,0.784867673,3569,-0.579477188
13283,860,1808,2700,0.318518519,0.66962963,948,-0.351111111,GA,Treutlen County,,2738,1068,1646,0.390065741,0.601168736,578,-0.211102995
13285,9597,15643,25793,0.372077695,0.606482379,6046,-0.234404683,GA,Troup County,,25975,10545,15170,0.405967276,0.584023099,4625,-0.178055823
13287,1243,2094,3390,0.366666667,0.617699115,851,-0.251032448,GA,Turner County,,3556,1508,2027,0.424071991,0.570022497,519,-0.145950506
13289,1970,2034,4053,0.486059709,0.501850481,64,-0.015790772,GA,Twiggs County,,4199,2269,1905,0.540366754,0.453679447,364,0.086687307
13291,1962,9849,12039,0.162970346,0.818091204,7887,-0.655120857,GA,Union County,,11072,2137,8771,0.193009393,0.792178468,6634,-0.599169075
13293,3471,7288,10924,0.317740754,0.667154888,3817,-0.349414134,GA,Upson County,,11257,3955,7229,0.351336946,0.6421782,3274,-0.290841254
13295,4213,18938,23939,0.175988972,0.791094031,14725,-0.615105059,GA,Walker County,,21879,5269,16245,0.240824535,0.742492801,10976,-0.501668266
13297,8279,31093,40425,0.204799011,0.769152752,22814,-0.564353741,GA,Walton County,,37570,8139,29018,0.216635614,0.772371573,20879,-0.55573596
13299,3436,8508,12150,0.282798354,0.700246914,5072,-0.41744856,GA,Ware County,,11923,3892,7933,0.326427912,0.66535268,4041,-0.338924767
13301,1313,991,2332,0.563036021,0.424957118,322,0.138078902,GA,Warren County,,2522,1525,990,0.604678826,0.392545599,535,0.212133228
13303,4187,4138,8422,0.497150321,0.491332225,49,0.005818095,GA,Washington County,,8796,4705,4033,0.534902228,0.458503865,672,0.076398363
13305,2039,8147,10376,0.19651118,0.785177332,6108,-0.588666153,GA,Wayne County,,10258,2594,7553,0.252875804,0.736303373,4959,-0.483427569
13307,471,630,1114,0.422800718,0.565529623,159,-0.142728905,GA,Webster County,,1175,573,598,0.487659574,0.50893617,25,-0.021276596
13309,646,1421,2102,0.307326356,0.676022835,775,-0.36869648,GA,Wheeler County,,2160,772,1366,0.357407407,0.632407407,594,-0.275
13311,1672,9751,11771,0.142044006,0.82839181,8079,-0.686347804,GA,White County,,10471,1670,8647,0.15948811,0.825804603,6977,-0.666316493
13313,7925,21514,30362,0.261017061,0.708583097,13589,-0.447566036,GA,Whitfield County,,26828,7193,19290,0.268115402,0.719024899,12097,-0.450909498
13315,852,2096,2973,0.286579213,0.705011773,1244,-0.41843256,GA,Wilcox County,,3124,1059,2050,0.338988476,0.656209987,991,-0.317221511
13317,1844,2569,4470,0.412527964,0.574720358,725,-0.162192394,GA,Wilkes County,,4746,2080,2628,0.438263801,0.553729456,548,-0.115465655
13319,1893,2332,4276,0.442703461,0.545369504,439,-0.102666043,GA,Wilkinson County,,4448,2180,2245,0.490107914,0.504721223,65,-0.014613309
13321,2015,6144,8266,0.243769659,0.743285749,4129,-0.49951609,GA,Worth County,,8410,2486,5864,0.295600476,0.697265161,3378,-0.401664685
15001,41258,17500,64865,0.636059508,0.269791105,23758,0.366268404,HI,Hawaii County,,62653,46670,14541,0.744896493,0.232087849,32129,0.512808644
15003,175634,90296,285683,0.614786319,0.31607061,85338,0.298715709,HI,Honolulu County,,292925,201803,87255,0.688923786,0.297874883,114548,0.391048903
15007,16456,7574,26335,0.624871844,0.287602051,8882,0.337269793,HI,Kauai County,,25369,18638,6121,0.73467618,0.241278726,12517,0.493397454
15009,33479,13445,51942,0.64454584,0.258846406,20034,0.385699434,HI,Maui County,,48547,35979,11577,0.741116856,0.238469936,24402,0.502646919
16001,75676,93748,195587,0.386917331,0.47931611,18072,-0.092398779,ID,Ada County,,180361,77043,97471,0.427159974,0.54042171,20428,-0.113261736
16003,415,1556,2183,0.19010536,0.712780577,1141,-0.522675218,ID,Adams County,,2060,577,1413,0.280097087,0.68592233,836,-0.405825243
16005,10342,17180,33405,0.309594372,0.514294267,6838,-0.204699895,ID,Bannock County,,35260,13214,21010,0.374758934,0.595859331,7796,-0.221100397
16007,255,2203,2928,0.087090164,0.75239071,1948,-0.665300546,ID,Bear Lake County,,2822,302,2489,0.1070163,0.881998583,2187,-0.774982282
16009,780,3101,4192,0.186068702,0.739742366,2321,-0.553673664,ID,Benewah County,,3884,1164,2596,0.29969104,0.66838311,1432,-0.36869207
16011,2924,10907,16625,0.175879699,0.65606015,7983,-0.480180451,ID,Bingham County,,17603,3822,13440,0.217122081,0.763506221,9618,-0.546384139
16013,6416,3340,10723,0.598340017,0.311479996,3076,0.286860021,ID,Blaine County,,10194,5992,3939,0.587796743,0.386403767,2053,0.201392976
16015,777,2673,3812,0.20383001,0.701206716,1896,-0.497376705,ID,Boise County,,3345,953,2284,0.28490284,0.682810164,1331,-0.397907324
16017,5140,10220,16815,0.305679453,0.607790663,5080,-0.30211121,ID,Bonner County,,18536,6500,11367,0.350668968,0.613239102,4867,-0.262570134
16019,8930,26699,44212,0.201981363,0.603885823,17769,-0.40190446,ID,Bonneville County,,43302,9929,32336,0.229296568,0.746755346,22407,-0.517458778
16021,933,3789,5150,0.181165049,0.735728155,2856,-0.554563107,ID,Boundary County,,4544,1225,3138,0.269586268,0.690580986,1913,-0.420994718
16023,160,914,1230,0.130081301,0.743089431,754,-0.61300813,ID,Butte County,,1286,258,1001,0.200622084,0.778382582,743,-0.577760498
16025,110,410,599,0.183639399,0.684474124,300,-0.500834725,ID,Camas County,,578,159,402,0.275086505,0.69550173,243,-0.420415225
16027,16683,46755,72007,0.231685808,0.649311872,30072,-0.417626064,ID,Canyon County,,66090,19866,44369,0.300590104,0.671342109,24503,-0.370752005
16029,271,2275,3035,0.089291598,0.749588138,2004,-0.66029654,ID,Caribou County,,3050,385,2608,0.126229508,0.855081967,2223,-0.728852459
16031,1036,5949,8178,0.12668134,0.727439472,4913,-0.600758132,ID,Cassia County,,8387,1093,7150,0.130320734,0.852509837,6057,-0.722189102
16033,44,203,283,0.155477032,0.717314488,159,-0.561837456,ID,Clark County,,328,66,235,0.201219512,0.716463415,169,-0.515243902
16035,704,2852,3801,0.185214417,0.750328861,2148,-0.565114444,ID,Clearwater County,,3696,1032,2541,0.279220779,0.6875,1509,-0.408279221
16037,427,1777,2413,0.176958143,0.736427683,1350,-0.55946954,ID,Custer County,,2352,530,1744,0.225340136,0.741496599,1214,-0.516156463
16039,1814,5816,8519,0.212935791,0.682709238,4002,-0.469773448,ID,Elmore County,,8001,2513,5227,0.314085739,0.653293338,2714,-0.339207599
16041,385,3901,5499,0.07001273,0.709401709,3516,-0.63938898,ID,Franklin County,,5600,325,5195,0.058035714,0.927678571,4870,-0.869642857
16043,651,4091,5714,0.113930697,0.715960798,3440,-0.602030102,ID,Fremont County,,5802,810,4907,0.139607032,0.845742847,4097,-0.706135815
16045,1229,5980,7952,0.154552314,0.752012072,4751,-0.597459759,ID,Gem County,,7490,1957,5311,0.261281709,0.709078772,3354,-0.447797063
16047,930,3743,5191,0.179156232,0.721055673,2813,-0.541899441,ID,Gooding County,,5118,1287,3696,0.251465416,0.722157093,2409,-0.470691676
16049,1196,6441,8223,0.145445701,0.78329077,5245,-0.637845069,ID,Idaho County,,7749,1722,5821,0.222222222,0.751193702,4099,-0.52897148
16051,976,8436,11471,0.085084125,0.735419754,7460,-0.650335629,ID,Jefferson County,,11381,1303,9895,0.114489061,0.869431509,8592,-0.754942448
16053,2117,7347,10667,0.198462548,0.688759726,5230,-0.490297178,ID,Jerome County,,6681,1699,4804,0.254303248,0.719054034,3105,-0.464750786
16055,16264,44449,66286,0.245361011,0.67056392,28185,-0.425202909,ID,Kootenai County,,59764,18824,39347,0.314972224,0.658372934,20523,-0.343400709
16057,8093,7255,18146,0.445993607,0.399812631,838,0.046180977,ID,Latah County,,16759,8306,7589,0.495614297,0.452831315,717,0.042782982
16059,733,3011,4068,0.180186824,0.740167158,2278,-0.559980334,ID,Lemhi County,,4109,960,3029,0.233633487,0.737162327,2069,-0.503528839
16061,270,1202,1590,0.169811321,0.755974843,932,-0.586163522,ID,Lewis County,,1612,396,1173,0.245657568,0.727667494,777,-0.482009926
16063,360,1184,1748,0.205949657,0.677345538,824,-0.471395881,ID,Lincoln County,,1622,429,1141,0.264488286,0.703452528,712,-0.438964242
16065,1201,8941,15687,0.076560209,0.569962389,7740,-0.49340218,ID,Madison County,,14412,832,13445,0.05772967,0.932903136,12613,-0.875173467
16067,1167,4887,6870,0.169868996,0.711353712,3720,-0.541484716,ID,Minidoka County,,6973,1390,5442,0.199340313,0.780438836,4052,-0.581098523
16069,4828,10699,17195,0.280779296,0.62221576,5871,-0.341436464,ID,Nez Perce County,,16848,6451,9967,0.382894112,0.591583571,3516,-0.208689459
16071,184,1531,2068,0.088974855,0.74032882,1347,-0.651353965,ID,Oneida County,,2089,217,1838,0.103877453,0.879846817,1621,-0.775969363
16073,591,3052,3920,0.150765306,0.778571429,2461,-0.627806122,ID,Owyhee County,,3723,833,2794,0.223744292,0.750470051,1961,-0.526725759
16075,892,4306,5703,0.156408908,0.755041206,3414,-0.598632299,ID,Payette County,,8495,2271,6004,0.267333726,0.706768687,3733,-0.439434962
16077,699,1666,2758,0.253444525,0.604060914,967,-0.350616389,ID,Power County,,2903,982,1870,0.338270754,0.644161213,888,-0.305890458
16079,1384,3297,5120,0.2703125,0.643945313,1913,-0.373632812,ID,Shoshone County,,5148,2277,2699,0.442307692,0.524281274,422,-0.081973582
16081,2157,2161,4966,0.434353605,0.435159082,4,-0.000805477,ID,Teton County,,4523,1926,2458,0.425823568,0.543444616,532,-0.117621048
16083,6844,21063,31893,0.214592544,0.660427053,14219,-0.445834509,ID,Twin Falls County,,28142,7541,19773,0.267962476,0.702615308,12232,-0.434652832
16085,1913,2906,5349,0.357636941,0.543279118,993,-0.185642176,ID,Valley County,,4919,2095,2664,0.425899573,0.541573491,569,-0.115673917
16087,776,3283,4454,0.174225415,0.737090256,2507,-0.562864841,ID,Washington County,,4330,1104,3128,0.254965358,0.722401848,2024,-0.46743649
17001,7633,22732,31770,0.240258105,0.715517784,15099,-0.475259679,IL,Adams County,,30538,9627,20371,0.315246578,0.667070535,10744,-0.351823957
17003,1262,1496,2820,0.44751773,0.530496454,234,-0.082978723,IL,Alexander County,,3495,1961,1485,0.561087268,0.424892704,476,0.136194564
17005,2066,4884,7462,0.276869472,0.654516215,2818,-0.377646744,IL,Bond County,,7316,3016,4091,0.41224713,0.559185347,1075,-0.146938218
17007,8952,12261,22604,0.3960361,0.542426119,3309,-0.146390019,IL,Boone County,,21333,9868,11084,0.462569728,0.519570618,1216,-0.057000891
17009,475,1776,2336,0.203339041,0.760273973,1301,-0.556934932,IL,Brown County,,2362,787,1511,0.33319221,0.639712108,724,-0.306519898
17011,6010,9264,16303,0.368643808,0.568238974,3254,-0.199595167,IL,Bureau County,,16599,8118,8151,0.489065606,0.491053678,33,-0.001988072
17013,739,1719,2556,0.289123631,0.672535211,980,-0.383411581,IL,Calhoun County,,2574,1079,1439,0.419191919,0.559052059,360,-0.13986014
17015,2437,4428,7354,0.331384281,0.602121295,1991,-0.270737014,IL,Carroll County,,7370,3658,3551,0.496336499,0.481818182,107,0.014518318
17017,1617,3216,5054,0.319944598,0.636327661,1599,-0.316383063,IL,Cass County,,4858,2050,2707,0.421984356,0.557225196,657,-0.13524084
17019,49694,33235,89196,0.557132607,0.372606395,16459,0.184526212,IL,Champaign County,,77620,40378,35086,0.520200979,0.452022675,5292,0.068178305
17021,3982,10522,15310,0.260091444,0.687263227,6540,-0.427171783,IL,Christian County,,14682,5487,8873,0.373722926,0.604345457,3386,-0.230622531
17023,1873,5620,7819,0.239544699,0.71876199,3747,-0.479217291,IL,Clark County,,7843,2587,5138,0.329848272,0.655106464,2551,-0.325258192
17025,1014,5009,6278,0.161516406,0.797865562,3995,-0.636349156,IL,Clay County,,5899,1581,4184,0.268011527,0.709272758,2603,-0.441261231
17027,3939,12394,17268,0.228109798,0.717743804,8455,-0.489634005,IL,Clinton County,,16394,5577,10493,0.340185434,0.640051238,4916,-0.299865805
17029,7285,12985,21580,0.337581094,0.601714551,5700,-0.264133457,IL,Coles County,,21338,9252,11623,0.433592652,0.54470897,2371,-0.111116318
17031,1528582,440213,2055215,0.743757709,0.214193162,1088369,0.529564547,IL,Cook County,,1944401,1439123,479204,0.740136937,0.246453278,959919,0.493683659
17033,1969,6146,8507,0.231456448,0.722463853,4177,-0.491007406,IL,Crawford County,,8598,2855,5577,0.332053966,0.648639218,2722,-0.316585252
17035,1028,4200,5513,0.186468348,0.761835661,3172,-0.575367314,IL,Cumberland County,,5290,1640,3506,0.310018904,0.662759924,1866,-0.352741021
17037,20348,19051,42605,0.477596526,0.44715409,1297,0.030442436,IL,DeKalb County,,41020,21171,18906,0.516114091,0.460897123,2265,0.055216967
17039,1907,5072,7469,0.255321998,0.679073504,3165,-0.423751506,IL,De Witt County,,7338,2598,4576,0.354047424,0.623603162,1978,-0.269555737
17041,1946,5695,8089,0.240573618,0.704042527,3749,-0.463468908,IL,Douglas County,,7889,2426,5331,0.307516796,0.675751046,2905,-0.36823425
17043,222499,164355,412929,0.538831131,0.39802242,58144,0.14080871,IL,DuPage County,,397173,197411,193333,0.497040333,0.486772767,4078,0.010267566
17045,1778,5634,7783,0.228446614,0.723885391,3856,-0.495438777,IL,Edgar County,,7810,2563,5125,0.328169014,0.656209987,2562,-0.328040973
17047,432,2777,3312,0.130434783,0.838466184,2345,-0.708031401,IL,Edwards County,,3225,754,2402,0.23379845,0.744806202,1648,-0.511007752
17049,3071,13613,17428,0.176210695,0.78109938,10542,-0.604888685,IL,Effingham County,,16595,3855,12491,0.232298885,0.752696595,8636,-0.52039771
17051,1814,7363,9515,0.190646348,0.773830793,5549,-0.583184446,IL,Fayette County,,8963,2848,5950,0.317750753,0.663840232,3102,-0.346089479
17053,1410,4474,6289,0.224200986,0.711400859,3064,-0.487199873,IL,Ford County,,6000,1654,4225,0.275666667,0.704166667,2571,-0.4285
17055,4711,13101,18533,0.254195219,0.706901203,8390,-0.452705984,IL,Franklin County,,17891,7245,10253,0.404952211,0.573081438,3008,-0.168129227
17057,6118,8482,15609,0.39195336,0.543404446,2364,-0.151451086,IL,Fulton County,,15337,8324,6622,0.54273978,0.431766317,1702,0.110973463
17059,656,1942,2691,0.243775548,0.721664809,1286,-0.47788926,IL,Gallatin County,,2569,1028,1492,0.400155703,0.580770728,464,-0.180615025
17061,1202,4139,5542,0.21688921,0.746842295,2937,-0.529953086,IL,Greene County,,5614,2023,3446,0.360349127,0.613822586,1423,-0.253473459
17063,8021,13417,22891,0.35039972,0.586125552,5396,-0.235725831,IL,Grundy County,,20956,9319,11198,0.444693644,0.534357702,1879,-0.089664058
17065,800,3205,4143,0.19309679,0.773594014,2405,-0.580497224,IL,Hamilton County,,3935,1266,2566,0.321728081,0.652096569,1300,-0.330368488
17067,1744,5713,7818,0.223074955,0.730749552,3969,-0.507674597,IL,Hancock County,,8229,3246,4810,0.394458622,0.584518167,1564,-0.190059546
17069,419,1650,2133,0.196436943,0.773558368,1231,-0.577121425,IL,Hardin County,,2330,742,1535,0.318454936,0.658798283,793,-0.340343348
17071,1151,2153,3480,0.330747126,0.618678161,1002,-0.287931034,IL,Henderson County,,3563,1977,1538,0.554869492,0.431658715,439,0.123210777
17073,8835,13962,24232,0.364600528,0.576180258,5127,-0.211579729,IL,Henry County,,24279,12316,11564,0.507269657,0.476296388,752,0.030973269
17075,2496,9728,12923,0.193144007,0.752766386,7232,-0.559622379,IL,Iroquois County,,12770,3408,9115,0.266875489,0.713782302,5707,-0.446906813
17077,11619,10889,24509,0.47407075,0.444285773,730,0.029784977,IL,Jackson County,,21190,11306,9130,0.533553563,0.430863615,2176,0.102689948
17079,924,3973,5104,0.181034483,0.778409091,3049,-0.597374608,IL,Jasper County,,5038,1434,3511,0.284636761,0.696903533,2077,-0.412266773
17081,4408,11681,16818,0.262100131,0.694553455,7273,-0.432453324,IL,Jefferson County,,16303,6080,9805,0.372937496,0.601423051,3725,-0.228485555
17083,2673,7737,10909,0.245027042,0.70923091,5064,-0.464203868,IL,Jersey County,,9940,3656,6032,0.367806841,0.606841046,2376,-0.239034205
17085,4452,6113,11177,0.398317974,0.546926725,1661,-0.14860875,IL,Jo Daviess County,,11411,5660,5529,0.496012619,0.484532469,131,0.011480151
17087,1135,4644,6017,0.188632209,0.771813196,3509,-0.583180987,IL,Johnson County,,5666,1571,3959,0.277267914,0.698729262,2388,-0.421461348
17089,99389,82087,193500,0.513638243,0.424222222,17302,0.089416021,IL,Kane County,,183631,91120,89502,0.496212513,0.487401365,1618,0.008811148
17091,18908,25081,46556,0.406134548,0.538727554,6173,-0.132593006,IL,Kankakee County,,45452,21574,23115,0.474654581,0.508558479,1541,-0.033903899
17093,23392,24152,50815,0.460336515,0.475292729,760,-0.014956214,IL,Kendall County,,45042,21219,23076,0.471093646,0.512321833,1857,-0.041228187
17095,9939,10658,21964,0.452513203,0.485248589,719,-0.032735385,IL,Knox County,,22517,12993,9133,0.577030688,0.405604654,3860,0.171426034
17097,168186,108608,293574,0.572891332,0.369951017,59578,0.202940315,IL,Lake County,,284032,151552,128609,0.533573682,0.452797572,22943,0.08077611
17099,19277,26269,48447,0.397898735,0.542221397,6992,-0.144322662,IL,LaSalle County,,47146,23023,23207,0.488334111,0.492236881,184,-0.00390277
17101,1288,4517,6039,0.213280344,0.747971518,3229,-0.534691174,IL,Lawrence County,,5984,2010,3853,0.335895722,0.64388369,1843,-0.307987968
17103,5499,8597,15215,0.361419652,0.565034505,3098,-0.203614854,IL,Lee County,,15275,6932,8046,0.453813421,0.526743044,1114,-0.072929624
17105,4005,10197,15096,0.265302067,0.675476948,6192,-0.410174881,IL,Livingston County,,15019,5014,9745,0.333843798,0.648844797,4731,-0.315000999
17107,3301,8167,12130,0.272135202,0.673289365,4866,-0.401154163,IL,Logan County,,12037,3974,7835,0.330148708,0.650909695,3861,-0.320760987
17109,5278,6789,12910,0.408830364,0.525871418,1511,-0.117041053,IL,McDonough County,,12439,5957,6142,0.478897017,0.493769596,185,-0.014872578
17111,59827,71117,140145,0.426893575,0.507452995,11290,-0.080559421,IL,McHenry County,,133589,59691,71488,0.446825712,0.535133881,11797,-0.088308169
17113,35918,37081,78995,0.454687006,0.469409456,1163,-0.014722451,IL,McLean County,,72756,31590,39638,0.434190995,0.544807301,8048,-0.110616307
17115,18211,26782,47283,0.385148996,0.56641922,8571,-0.181270224,IL,Macon County,,48742,22688,25249,0.465471257,0.518013212,2561,-0.052541956
17117,6532,14194,21881,0.298523833,0.648690645,7662,-0.350166811,IL,Macoupin County,,20947,9440,10909,0.450661193,0.520790567,1469,-0.070129374
17119,50336,70295,127902,0.393551313,0.549600475,19959,-0.156049163,IL,Madison County,,122203,58813,60481,0.481272964,0.494922383,1668,-0.013649419
17121,4231,11677,16600,0.254879518,0.703433735,7446,-0.448554217,IL,Marion County,,15728,6210,9229,0.394837233,0.586787894,3019,-0.191950661
17123,1784,3776,5903,0.302219211,0.639674742,1992,-0.337455531,IL,Marshall County,,5842,2452,3287,0.419719274,0.562649777,835,-0.142930503
17125,2008,4051,6433,0.312140525,0.629721747,2043,-0.317581222,IL,Mason County,,6272,2867,3265,0.457110969,0.520567602,398,-0.063456633
17127,1555,4844,6633,0.234433891,0.730287954,3289,-0.495854063,IL,Massac County,,6492,2092,4278,0.32224276,0.65896488,2186,-0.33672212
17129,1808,4230,6423,0.281488401,0.658570761,2422,-0.37708236,IL,Menard County,,6142,2095,3944,0.341094106,0.642136112,1849,-0.301042006
17131,3061,4800,8417,0.363668766,0.570274445,1739,-0.206605679,IL,Mercer County,,8525,4503,3874,0.528211144,0.454428152,629,0.073782991
17133,5522,12614,19074,0.289504037,0.661319073,7092,-0.371815036,IL,Monroe County,,17407,6205,10879,0.35646579,0.624978457,4674,-0.268512667
17135,3490,8616,12829,0.27203991,0.671603399,5126,-0.399563489,IL,Montgomery County,,12120,5053,6771,0.416914191,0.558663366,1718,-0.141749175
17137,4693,9060,14607,0.321284316,0.620250565,4367,-0.298966249,IL,Morgan County,,14071,5792,7962,0.41162675,0.565844645,2170,-0.154217895
17139,1476,4453,6209,0.23771944,0.717184732,2977,-0.479465292,IL,Moultrie County,,6052,2142,3781,0.353932584,0.624752148,1639,-0.270819564
17141,8025,14344,23798,0.337213211,0.602739726,6319,-0.265526515,IL,Ogle County,,23342,9504,13409,0.407163054,0.574458058,3905,-0.167295005
17143,37436,35299,77465,0.483263409,0.455676757,2137,0.027586652,IL,Peoria County,,78060,40050,36617,0.513066872,0.469087881,3433,0.043978991
17145,2433,6816,9706,0.250669689,0.702246033,4383,-0.451576345,IL,Perry County,,9533,3813,5497,0.39997902,0.576628553,1684,-0.176649533
17147,2633,5623,8899,0.295875941,0.631868749,2990,-0.335992808,IL,Piatt County,,8697,3081,5412,0.35426009,0.622283546,2331,-0.268023456
17149,1412,5749,7458,0.189326897,0.770850094,4337,-0.581523197,IL,Pike County,,7275,2276,4853,0.312852234,0.667079038,2577,-0.354226804
17151,374,1678,2132,0.175422139,0.787054409,1304,-0.61163227,IL,Pope County,,2219,649,1511,0.292474087,0.680937359,862,-0.388463272
17153,817,1583,2473,0.330367974,0.640113223,766,-0.309745249,IL,Pulaski County,,3001,1389,1562,0.462845718,0.520493169,173,-0.057647451
17155,1143,1762,3076,0.371586476,0.572821847,619,-0.201235371,IL,Putnam County,,3132,1558,1500,0.497445722,0.478927203,58,0.018518519
17157,3421,9992,14032,0.243799886,0.712086659,6571,-0.468286773,IL,Randolph County,,14380,5753,8284,0.400069541,0.576077886,2531,-0.176008345
17159,1579,5736,7630,0.206946265,0.751769332,4157,-0.544823067,IL,Richland County,,7274,2360,4750,0.324443222,0.653010723,2390,-0.328567501
17161,32258,26969,62971,0.512267552,0.428276508,5289,0.083991043,IL,Rock Island County,,64880,39081,24888,0.6023582,0.383600493,14193,0.218757707
17163,60180,53479,119201,0.504861536,0.448645565,6701,0.056215971,IL,St. Clair County,,118379,66749,49610,0.563858455,0.419077708,17139,0.144780747
17165,2551,8248,11234,0.227078512,0.734199751,5697,-0.507121239,IL,Saline County,,10713,3697,6803,0.345094745,0.635022869,3106,-0.289928125
17167,40731,49823,96472,0.422205407,0.516450369,9092,-0.094244962,IL,Sangamon County,,94032,41961,50131,0.446241705,0.533127021,8170,-0.086885316
17169,1074,2523,3792,0.283227848,0.665348101,1449,-0.382120253,IL,Schuyler County,,3882,1726,2062,0.444616177,0.5311695,336,-0.086553323
17171,528,1965,2583,0.204413473,0.760743322,1437,-0.556329849,IL,Scott County,,2554,910,1586,0.356303837,0.620986688,676,-0.26468285
17173,2279,8209,10912,0.208852639,0.752291056,5930,-0.543438416,IL,Shelby County,,10383,3336,6837,0.321294424,0.658480208,3501,-0.337185784
17175,748,1777,2707,0.27632065,0.65644625,1029,-0.3801256,IL,Stark County,,2661,1095,1527,0.411499436,0.573844419,432,-0.162344983
17177,7531,10845,19525,0.385710627,0.555441741,3314,-0.169731114,IL,Stephenson County,,17029,7954,8742,0.46708556,0.513359563,788,-0.046274003
17179,20568,38620,63347,0.324687831,0.609657916,18052,-0.284970085,IL,Tazewell County,,60903,24385,35266,0.400390785,0.579051935,10881,-0.17866115
17181,2389,5780,8514,0.280596664,0.678881842,3391,-0.398285177,IL,Union County,,8274,3135,4951,0.378897752,0.598380469,1816,-0.219482717
17183,9876,18582,29799,0.331420517,0.623577972,8706,-0.292157455,IL,Vermilion County,,26153,10773,14888,0.41192215,0.569265476,4115,-0.157343326
17185,1146,4039,5402,0.21214365,0.747686042,2893,-0.535542392,IL,Wabash County,,5127,1588,3473,0.309732787,0.677394188,1885,-0.3676614
17187,2983,4267,7700,0.387402597,0.554155844,1284,-0.166753247,IL,Warren County,,7476,3893,3460,0.520733012,0.462814339,433,0.057918673
17189,1446,5566,7376,0.196041215,0.754609544,4120,-0.55856833,IL,Washington County,,7398,2448,4787,0.330900243,0.647066775,2339,-0.316166531
17191,1048,6963,8256,0.126937984,0.843386628,5915,-0.716448643,IL,Wayne County,,7676,1514,5984,0.197238145,0.779572694,4470,-0.582334549
17193,1412,5639,7289,0.193716559,0.7736315,4227,-0.57991494,IL,White County,,7059,2187,4729,0.309817255,0.669924919,2542,-0.360107664
17195,11005,12597,25210,0.436533122,0.499682666,1592,-0.063149544,IL,Whiteside County,,21492,12393,8676,0.576633166,0.403685092,3717,0.172948074
17197,146230,129726,291010,0.502491323,0.445778496,16504,0.056712828,IL,Will County,,249708,127522,118366,0.510684479,0.474017653,9156,0.036666827
17199,8539,21503,31422,0.271752275,0.684329451,12964,-0.412577175,IL,Williamson County,,29079,10622,17880,0.365280787,0.614876715,7258,-0.249595928
17201,52595,53922,113027,0.465331293,0.47707185,1327,-0.011740558,IL,Winnebago County,,116101,60334,53722,0.51966822,0.462717806,6612,0.056950414
17203,5068,13180,19389,0.261385322,0.679766878,8112,-0.418381557,IL,Woodford County,,18848,5564,12947,0.295203735,0.686916384,7383,-0.391712649
18001,2802,9642,13039,0.21489378,0.739473886,6840,-0.524580106,IN,Adams County,,12998,3800,8936,0.29235267,0.687490383,5136,-0.395137713
18003,55222,83801,145787,0.378785488,0.574818056,28579,-0.196032568,IN,Allen County,,146405,59834,84378,0.408688228,0.576332776,24544,-0.167644548
18005,9841,20637,32389,0.303837723,0.637160764,10796,-0.333323042,IN,Bartholomew County,,29313,10622,18083,0.362364821,0.616893528,7461,-0.254528707
18007,860,2579,3654,0.235358511,0.705801861,1719,-0.47044335,IN,Benton County,,3577,1159,2329,0.324014537,0.651104277,1170,-0.32708974
18009,1243,3349,4822,0.257776856,0.694525093,2106,-0.436748237,IN,Blackford County,,4740,1927,2710,0.406540084,0.571729958,783,-0.165189873
18011,10181,19654,32061,0.317550919,0.613018933,9473,-0.295468014,IN,Boone County,,27725,8326,18807,0.300306583,0.678340848,10481,-0.378034265
18013,2518,5015,7908,0.318411735,0.634167931,2497,-0.315756196,IN,Brown County,,7590,3056,4330,0.402635046,0.570487484,1274,-0.167852437
18015,1891,6273,8609,0.219653851,0.728656058,4382,-0.509002207,IN,Carroll County,,7793,2631,4993,0.337610676,0.640703195,2362,-0.303092519
18017,3758,9697,14135,0.265864874,0.686027591,5939,-0.420162717,IN,Cass County,,14137,5365,8432,0.379500601,0.596449034,3067,-0.216948433
18019,18791,30012,51104,0.367701158,0.587273012,11221,-0.219571853,IN,Clark County,,47062,20775,25422,0.441438953,0.540181038,4647,-0.098742085
18021,2306,8528,11259,0.204813927,0.757438494,6222,-0.552624567,IN,Clay County,,10922,3630,7065,0.332356711,0.64685955,3435,-0.314502838
18023,2819,8530,11896,0.23697041,0.717047747,5711,-0.480077337,IN,Clinton County,,9879,3307,6338,0.334750481,0.641562911,3031,-0.30681243
18025,1323,3013,4591,0.288172511,0.656284034,1690,-0.368111523,IN,Crawford County,,4586,2040,2418,0.444832098,0.527256869,378,-0.082424771
18027,1800,8545,10736,0.167660209,0.795920268,6745,-0.62826006,IN,Daviess County,,10246,2437,7638,0.237848917,0.745461644,5201,-0.507612727
18029,4883,18110,23910,0.204224174,0.757423672,13227,-0.553199498,IN,Dearborn County,,22352,6527,15391,0.292009664,0.688573729,8864,-0.396564066
18031,2121,8488,11095,0.191167192,0.765029292,6367,-0.5738621,IN,Decatur County,,10303,2941,7119,0.28545084,0.690963797,4178,-0.405512957
18033,3941,12054,16816,0.234360133,0.716817317,8113,-0.482457184,IN,DeKalb County,,16314,5419,10586,0.332168689,0.648890523,5167,-0.316721834
18035,18100,24217,44699,0.404930759,0.541779458,6117,-0.136848699,IN,Delaware County,,44924,22630,21231,0.503739649,0.472598166,1399,0.031141483
18037,5389,13365,19917,0.270572877,0.671034794,7976,-0.400461917,IN,Dubois County,,18542,6522,11654,0.351741991,0.628519038,5132,-0.276777047
18039,20667,41810,65187,0.317041741,0.641385552,21143,-0.324343811,IN,Elkhart County,,67768,24376,42348,0.359697792,0.624896706,17972,-0.265198914
18041,2252,6839,9530,0.236306401,0.717628541,4587,-0.481322141,IN,Fayette County,,8816,3553,5044,0.403017241,0.572141561,1491,-0.169124319
18043,13939,21427,37225,0.374452653,0.57560779,7488,-0.201155138,IN,Floyd County,,35283,14805,19868,0.419607176,0.563104044,5063,-0.143496868
18045,1476,5661,7474,0.197484613,0.757425743,4185,-0.559941129,IN,Fountain County,,7103,2233,4660,0.314374208,0.656060819,2427,-0.341686611
18047,1967,8665,10990,0.178980892,0.78844404,6698,-0.609463148,IN,Franklin County,,10549,2907,7421,0.275571144,0.703479003,4514,-0.427907859
18049,1960,6010,8374,0.234057798,0.717697636,4050,-0.483639838,IN,Fulton County,,8120,2621,5315,0.322783251,0.65455665,2694,-0.331773399
18051,3720,11079,15472,0.240434333,0.716067735,7359,-0.475633402,IN,Gibson County,,14718,4928,9487,0.334828102,0.644584862,4559,-0.30975676
18053,7029,17009,25239,0.278497563,0.67391735,9980,-0.395419787,IN,Grant County,,25258,9589,15148,0.379642094,0.599730778,5559,-0.220088685
18055,2929,10275,13763,0.212816973,0.746566882,7346,-0.533749909,IN,Greene County,,13101,4340,8457,0.331272422,0.645523243,4117,-0.314250821
18057,57214,87299,153630,0.372414242,0.56824188,30085,-0.195827638,IN,Hamilton County,,136803,43794,90740,0.320124559,0.663289548,46946,-0.343164989
18059,8901,25050,36027,0.247064701,0.695311849,16149,-0.448247148,IN,Hancock County,,32758,9303,22750,0.283991697,0.694486843,13447,-0.410495146
18061,4776,12993,18528,0.257772021,0.701262953,8217,-0.443490933,IN,Harrison County,,17646,6600,10629,0.374022441,0.602346141,4029,-0.228323699
18063,22595,48326,75258,0.300233862,0.642137713,25731,-0.341903851,IN,Hendricks County,,66590,21100,44308,0.316864394,0.665385193,23208,-0.348520799
18065,5124,13895,20075,0.255242839,0.692154421,8771,-0.436911582,IN,Henry County,,18996,7613,10836,0.400768583,0.570435881,3223,-0.169667298
18067,11215,23675,36754,0.305136856,0.644147576,12460,-0.33901072,IN,Howard County,,36194,15097,20284,0.417113334,0.56042438,5187,-0.143311046
18069,3506,11649,15974,0.219481658,0.729247527,8143,-0.50976587,IN,Huntington County,,15753,4596,10862,0.291753952,0.689519457,6266,-0.397765505
18071,3843,12857,17532,0.219199179,0.733344741,9014,-0.514145562,IN,Jackson County,,16704,5838,10419,0.349497126,0.623742816,4581,-0.27424569
18073,3329,9382,13331,0.249718701,0.70377316,6053,-0.45405446,IN,Jasper County,,12891,4672,7955,0.362423396,0.6170972,3283,-0.254673803
18075,1889,5697,7962,0.237251947,0.715523738,3808,-0.478271791,IN,Jay County,,7897,3063,4643,0.387868811,0.587944789,1580,-0.200075978
18077,4325,8538,13461,0.321298566,0.6342768,4213,-0.312978233,IN,Jefferson County,,13120,5728,7096,0.436585366,0.540853659,1368,-0.104268293
18079,2364,8222,11115,0.21268556,0.739721098,5858,-0.527035538,IN,Jennings County,,10237,3818,6112,0.372960828,0.597049917,2294,-0.224089089
18081,17318,45456,66229,0.26148666,0.686345861,28138,-0.424859201,IN,Johnson County,,57362,17080,39136,0.297758098,0.682263519,22056,-0.384505422
18083,3772,11077,15483,0.243622037,0.715429826,7305,-0.471807789,IN,Knox County,,15145,5228,9612,0.345196434,0.634664906,4384,-0.289468471
18085,6311,23909,31907,0.197793588,0.749334002,17598,-0.551540414,IN,Kosciusko County,,30039,6862,22553,0.228436366,0.750790639,15691,-0.522354273
18087,2080,7025,9552,0.217755444,0.735448074,4945,-0.51769263,IN,LaGrange County,,9311,2897,6227,0.311137364,0.668778864,3330,-0.357641499
18089,116896,75565,200247,0.583759058,0.377358962,41331,0.206400096,IN,Lake County,,201648,130824,68397,0.648774101,0.339190074,62427,0.309584028
18091,19795,22678,44994,0.439947549,0.504022759,2883,-0.06407521,IN,LaPorte County,,43657,24104,18609,0.552122226,0.426254667,5495,0.125867558
18093,4210,14034,19076,0.220696163,0.735688824,9824,-0.514992661,IN,Lawrence County,,17822,5779,11622,0.324262148,0.652115363,5843,-0.327853215
18095,18595,32376,53660,0.346533731,0.603354454,13781,-0.256820723,IN,Madison County,,52340,24404,26755,0.466259075,0.51117692,2351,-0.044917845
18097,212676,130228,361070,0.58901598,0.360672446,82448,0.228343534,IN,Marion County,,357745,215474,136131,0.602311702,0.380525234,79343,0.221786468
18099,4798,12286,18008,0.266437139,0.682252332,7488,-0.415815193,IN,Marshall County,,17751,6136,11260,0.345670666,0.63433046,5124,-0.288659794
18101,881,3695,4807,0.183274392,0.768670689,2814,-0.585396297,IN,Martin County,,4742,1351,3262,0.284900886,0.687895403,1911,-0.402994517
18103,2766,9975,13440,0.205803571,0.7421875,7209,-0.536383929,IN,Miami County,,12758,4220,8163,0.330772848,0.63983383,3943,-0.309060981
18105,34183,20527,57623,0.593217986,0.356229283,13656,0.236988702,IN,Monroe County,,40200,22885,16254,0.569278607,0.404328358,6631,0.164950249
18107,3362,11051,15101,0.222634263,0.731805841,7689,-0.509171578,IN,Montgomery County,,14349,4244,9768,0.29576974,0.680744303,5524,-0.384974563
18109,6037,23671,31180,0.193617704,0.759172547,17634,-0.565554843,IN,Morgan County,,28251,7969,19591,0.28207851,0.693462178,11622,-0.411383668
18111,1403,4074,5791,0.242272492,0.703505439,2671,-0.461232948,IN,Newton County,,5652,2212,3291,0.391365888,0.582271762,1079,-0.190905874
18113,3904,12198,16890,0.231142688,0.722202487,8294,-0.491059799,IN,Noble County,,16244,5229,10680,0.321903472,0.657473529,5451,-0.335570057
18115,686,2118,2917,0.235173123,0.726088447,1432,-0.490915324,IN,Ohio County,,2812,992,1757,0.352773826,0.624822191,765,-0.272048364
18117,2048,5800,8189,0.250091586,0.708267188,3752,-0.458175601,IN,Orange County,,7753,2939,4615,0.379079066,0.59525345,1676,-0.216174384
18119,1946,6151,8520,0.228403756,0.721948357,4205,-0.493544601,IN,Owen County,,8107,2823,5062,0.34821759,0.624398668,2239,-0.276181078
18121,1441,4863,6576,0.21913017,0.739507299,3422,-0.520377129,IN,Parke County,,6504,2106,4228,0.323800738,0.650061501,2122,-0.326260763
18123,3062,4556,8025,0.381557632,0.567725857,1494,-0.186168224,IN,Perry County,,7866,4314,3403,0.548436308,0.432621409,911,0.1158149
18125,1297,4398,5977,0.216998494,0.735820646,3101,-0.518822152,IN,Pike County,,5924,2125,3627,0.358710331,0.612255233,1502,-0.253544902
18127,33531,38719,76492,0.438359567,0.506183653,5188,-0.067824086,IN,Porter County,,72487,36950,34197,0.509746575,0.471767351,2753,0.037979224
18129,3515,8393,12448,0.282374679,0.674244859,4878,-0.39187018,IN,Posey County,,12216,4531,7427,0.370907007,0.60797315,2896,-0.237066143
18131,1327,3854,5437,0.24406842,0.708846791,2527,-0.46477837,IN,Pulaski County,,5399,1899,3366,0.351731802,0.623448787,1467,-0.271716985
18133,3356,10637,14680,0.228610354,0.724591281,7281,-0.495980926,IN,Putnam County,,13813,4504,9004,0.326069645,0.651849707,4500,-0.325780062
18135,2446,7515,10456,0.23393267,0.71872609,5069,-0.48479342,IN,Randolph County,,10188,3768,6218,0.369846879,0.610325874,2450,-0.240478995
18137,2471,9806,12790,0.193197811,0.766692729,7335,-0.573494918,IN,Ripley County,,10982,3241,7484,0.295119286,0.681478783,4243,-0.386359497
18139,1525,5292,7214,0.211394511,0.733573607,3767,-0.522179096,IN,Rush County,,7026,2221,4633,0.316111586,0.659407913,2412,-0.343296328
18141,52247,52019,109452,0.477350802,0.475267697,228,0.002083105,IN,St. Joseph County,,110644,56458,52575,0.510267163,0.475172626,3883,0.035094537
18143,2642,6074,9060,0.291611479,0.670419426,3432,-0.378807947,IN,Scott County,,8716,3998,4539,0.45869665,0.520766407,541,-0.062069757
18145,4247,12718,17935,0.236799554,0.709116253,8471,-0.472316699,IN,Shelby County,,16743,5357,10972,0.319954608,0.655318641,5615,-0.335364033
18147,2861,6572,9959,0.287277839,0.659905613,3711,-0.372627774,IN,Spencer County,,9725,4026,5515,0.413984576,0.567095116,1489,-0.15311054
18149,2489,6367,9226,0.269781054,0.690114893,3878,-0.420333839,IN,Starke County,,8752,3809,4738,0.435214808,0.541361974,929,-0.106147166
18151,3741,10127,14530,0.257467309,0.696971783,6386,-0.439504474,IN,Steuben County,,13677,4846,8542,0.354317467,0.624552168,3696,-0.270234701
18153,2113,6138,8559,0.246874635,0.717139853,4025,-0.470265218,IN,Sullivan County,,8289,3191,4902,0.38496803,0.591386174,1711,-0.206418145
18155,930,2558,3639,0.255564716,0.702940368,1628,-0.447375653,IN,Switzerland County,,3397,1437,1872,0.423020312,0.551074477,435,-0.128054165
18157,27207,30711,61916,0.439417921,0.496010724,3504,-0.056592803,IN,Tippecanoe County,,56696,26642,28708,0.469909694,0.506349654,2066,-0.03643996
18159,1587,5589,7510,0.211318242,0.744207723,4002,-0.532889481,IN,Tipton County,,7364,2432,4773,0.330255296,0.648153178,2341,-0.317897882
18161,715,2445,3286,0.217589775,0.744065733,1730,-0.526475959,IN,Union County,,3099,1018,2022,0.328493062,0.652468538,1004,-0.323975476
18163,28296,40422,71957,0.393234849,0.561752158,12126,-0.168517309,IN,Vanderburgh County,,72416,31659,39504,0.437182391,0.545514803,7845,-0.108332413
18165,2081,4511,6913,0.30102705,0.652538695,2430,-0.351511645,IN,Vermillion County,,6578,2979,3426,0.452873214,0.520826999,447,-0.067953785
18167,15922,21924,39569,0.402385706,0.554070105,6002,-0.151684399,IN,Vigo County,,39843,19707,19368,0.494616369,0.486107974,339,0.008508395
18169,3018,9819,13415,0.224972046,0.731941856,6801,-0.50696981,IN,Wabash County,,12702,3929,8528,0.309321367,0.671390332,4599,-0.362068966
18171,839,2896,3919,0.214085226,0.738964021,2057,-0.524878796,IN,Warren County,,3798,1324,2377,0.348604529,0.625855714,1053,-0.277251185
18173,9086,19133,29609,0.306866156,0.646188659,10047,-0.339322503,IN,Warrick County,,24627,8791,15350,0.356965932,0.62329963,6559,-0.266333699
18175,2636,8206,11333,0.232595076,0.72408012,5570,-0.491485044,IN,Washington County,,10725,3909,6532,0.364475524,0.609044289,2623,-0.244568765
18177,8322,16028,25575,0.325395894,0.626705767,7706,-0.301309873,IN,Wayne County,,25458,10591,14321,0.41601854,0.56253437,3730,-0.14651583
18179,2585,9999,13123,0.196982397,0.761944677,7414,-0.56496228,IN,Wells County,,12922,3434,9255,0.265748336,0.716220399,5821,-0.450472063
18181,2563,6813,9902,0.258836599,0.68804282,4250,-0.429206221,IN,White County,,9901,3635,5970,0.367134633,0.602969397,2335,-0.235834764
18183,3379,11357,15535,0.217508851,0.731058899,7978,-0.513550048,IN,Whitley County,,15005,4420,10257,0.294568477,0.683572143,5837,-0.389003665
19001,1127,2456,3759,0.29981378,0.653365257,1329,-0.353551476,IA,Adair County,,3959,1788,2110,0.451629199,0.532962869,322,-0.08133367
19003,565,1393,2082,0.271373679,0.669068204,828,-0.397694524,IA,Adams County,,2158,1018,1103,0.471733086,0.511121409,85,-0.039388323
19005,2409,4072,6837,0.352347521,0.595582858,1663,-0.243235337,IA,Allamakee County,,6824,3511,3230,0.51450762,0.473329426,281,0.041178195
19007,1813,4031,6096,0.297408136,0.661253281,2218,-0.363845144,IA,Appanoose County,,6176,2934,3153,0.475064767,0.510524611,219,-0.035459845
19009,1079,2135,3379,0.319325244,0.631843741,1056,-0.312518497,IA,Audubon County,,3439,1608,1800,0.467577784,0.523407967,192,-0.055830183
19011,4672,8226,13690,0.341271001,0.600876552,3554,-0.259605551,IA,Benton County,,13959,6850,6935,0.490722831,0.496812093,85,-0.006089261
19013,32006,27382,63221,0.506255833,0.433115579,4624,0.073140254,IA,Black Hawk County,,66205,39338,26078,0.594184729,0.393897742,13260,0.200286987
19015,5517,7458,13984,0.394522311,0.533323799,1941,-0.138801487,IA,Boone County,,14237,7457,6540,0.523776076,0.45936644,917,0.064409637
19017,5349,7199,13350,0.400674157,0.539250936,1850,-0.138576779,IA,Bremer County,,13218,6710,6383,0.507641095,0.482902103,327,0.024738992
19019,3966,5504,10137,0.391240012,0.542961428,1538,-0.151721417,IA,Buchanan County,,10478,5903,4443,0.563370872,0.424031304,1460,0.139339569
19021,2851,4895,8179,0.34857562,0.598483922,2044,-0.249908302,IA,Buena Vista County,,8322,3683,4548,0.442561884,0.546503244,865,-0.10394136
19023,2163,4918,7457,0.290063028,0.65951455,2755,-0.369451522,IA,Butler County,,7510,3321,4104,0.442210386,0.546471372,783,-0.104260985
19025,1396,3466,5105,0.273457395,0.678942214,2070,-0.405484819,IA,Calhoun County,,5190,2232,2890,0.430057803,0.556840077,658,-0.126782274
19027,3305,6627,10435,0.316722568,0.635074269,3322,-0.318351701,IA,Carroll County,,10581,4912,5577,0.464228334,0.527076836,665,-0.062848502
19029,1946,4755,7055,0.275832743,0.673990078,2809,-0.398157335,IA,Cass County,,7167,2856,4212,0.398493093,0.587693596,1356,-0.189200502
19031,3578,5275,9386,0.381206052,0.562007245,1697,-0.180801193,IA,Cedar County,,9548,4931,4510,0.516443234,0.47235023,421,0.044093004
19033,9840,11583,22633,0.434763399,0.511774842,1743,-0.077011443,IA,Cerro Gordo County,,23548,13204,10084,0.560727026,0.428231697,3120,0.132495329
19035,1676,4188,6186,0.270934368,0.677012609,2512,-0.406078241,IA,Cherokee County,,6367,2623,3656,0.41196796,0.574210774,1033,-0.162242815
19037,2264,3739,6367,0.355583477,0.587246741,1475,-0.231663264,IA,Chickasaw County,,6462,3552,2836,0.549675023,0.438873414,716,0.110801609
19039,1463,2706,4405,0.332122588,0.61430193,1243,-0.282179342,IA,Clarke County,,4398,2187,2124,0.497271487,0.482946794,63,0.014324693
19041,2246,5870,8542,0.262936081,0.687192695,3624,-0.424256614,IA,Clay County,,8400,3363,4934,0.400357143,0.587380952,1571,-0.18702381
19043,3236,5309,9098,0.355682568,0.583534843,2073,-0.227852275,IA,Clayton County,,9035,4768,4146,0.527725512,0.458882125,622,0.068843387
19045,10079,11249,22748,0.443071918,0.494505011,1170,-0.051433093,IA,Clinton County,,24873,15123,9423,0.608008684,0.37884453,5700,0.229164154
19047,1985,4608,6862,0.289274264,0.671524337,2623,-0.382250073,IA,Crawford County,,6686,3035,3584,0.453933593,0.536045468,549,-0.082111876
19049,15662,19288,37617,0.416354308,0.512746896,3626,-0.096392588,IA,Dallas County,,37799,16466,20921,0.43561999,0.553480251,4455,-0.117860261
19051,976,2721,3858,0.252980819,0.705287714,1745,-0.452306895,IA,Davis County,,3738,1518,2133,0.406099518,0.570626003,615,-0.164526485
19053,1201,2296,3703,0.324331623,0.620037807,1095,-0.295706184,IA,Decatur County,,3812,1790,1945,0.46956978,0.51023085,155,-0.04066107
19055,2956,5688,9165,0.322531369,0.620621931,2732,-0.298090562,IA,Delaware County,,9323,4605,4628,0.493939719,0.496406736,23,-0.002467017
19057,8178,9479,18713,0.437022391,0.506546251,1301,-0.06952386,IA,Des Moines County,,20264,11873,8130,0.58591591,0.401204106,3743,0.184711804
19059,3051,6743,10247,0.297745682,0.658046257,3692,-0.360300576,IA,Dickinson County,,10118,4088,5911,0.404032417,0.584206365,1823,-0.180173947
19061,22774,23384,49037,0.464424822,0.476864409,610,-0.012439586,IA,Dubuque County,,50516,28600,21265,0.566157257,0.420955737,7335,0.14520152
19063,1356,3121,4707,0.288081581,0.663055024,1765,-0.374973444,IA,Emmet County,,4646,2087,2499,0.449203616,0.537882049,412,-0.088678433
19065,3666,5591,9813,0.373586059,0.569754407,1925,-0.196168348,IA,Fayette County,,10309,5709,4484,0.553787952,0.434959744,1225,0.118828208
19067,3177,4371,7985,0.397871008,0.547401378,1194,-0.149530369,IA,Floyd County,,8228,4674,3466,0.568060282,0.421244531,1208,0.146815751
19069,1490,3153,4915,0.303153611,0.641505595,1663,-0.338351984,IA,Franklin County,,5133,2256,2818,0.439509059,0.548996688,562,-0.109487629
19071,959,2401,3554,0.269836804,0.675576815,1442,-0.405740011,IA,Fremont County,,3655,1636,1971,0.447606019,0.539261286,335,-0.091655267
19073,1688,2819,4762,0.354472911,0.59197816,1131,-0.23750525,IA,Greene County,,4804,2369,2373,0.493130724,0.493963364,4,-0.000832639
19075,1847,4516,6766,0.27298256,0.667454922,2669,-0.394472362,IA,Grundy County,,6890,2615,4205,0.379535559,0.61030479,1590,-0.230769231
19077,1720,3603,5654,0.304209409,0.637247966,1883,-0.333038557,IA,Guthrie County,,5843,2565,3164,0.438986822,0.541502653,599,-0.102515831
19079,2715,4450,7589,0.357754645,0.586375016,1735,-0.228620372,IA,Hamilton County,,7872,3776,3986,0.479674797,0.506351626,210,-0.026676829
19081,1582,3972,5815,0.27205503,0.683061049,2390,-0.411006019,IA,Hancock County,,5881,2506,3306,0.426118007,0.562149294,800,-0.136031287
19083,2774,5231,8423,0.329336341,0.621037635,2457,-0.291701294,IA,Hardin County,,8775,4021,4647,0.458233618,0.52957265,626,-0.071339031
19085,2123,4892,7378,0.287747357,0.663052318,2769,-0.375304961,IA,Harrison County,,7282,3131,4059,0.429964296,0.557401813,928,-0.127437517
19087,2897,5764,9286,0.311975016,0.620719362,2867,-0.308744346,IA,Henry County,,9613,4451,5025,0.463018829,0.522729637,574,-0.059710808
19089,1674,2611,4507,0.371422232,0.579321056,937,-0.207898824,IA,Howard County,,4625,2767,1793,0.59827027,0.387675676,974,0.210594595
19091,1251,3564,5033,0.248559507,0.708126366,2313,-0.459566859,IA,Humboldt County,,5124,1967,3099,0.383879781,0.604800937,1132,-0.220921155
19093,792,2655,3590,0.220612813,0.739554318,1863,-0.518941504,IA,Ida County,,3626,1317,2276,0.363210149,0.627688913,959,-0.264478764
19095,3070,5193,8789,0.349300262,0.590852202,2123,-0.24155194,IA,Iowa County,,8788,4118,4551,0.468593537,0.517865271,433,-0.049271734
19097,3837,5821,10204,0.376029008,0.570462564,1984,-0.194433555,IA,Jackson County,,10166,5877,4171,0.578103482,0.410289199,1706,0.167814283
19099,7108,10556,18776,0.378568385,0.562207073,3448,-0.183638688,IA,Jasper County,,19385,10240,8868,0.528243487,0.457467114,1372,0.070776373
19101,3702,3738,8001,0.462692163,0.467191601,36,-0.004499438,IA,Jefferson County,,8405,4772,3429,0.567757287,0.407971446,1343,0.159785842
19103,49942,20993,75637,0.66028531,0.277549348,28949,0.382735963,IA,Johnson County,,74928,50090,23556,0.668508435,0.314381807,26534,0.354126628
19105,3779,5718,10011,0.377484767,0.571171711,1939,-0.193686944,IA,Jones County,,10371,5514,4712,0.531674863,0.454343843,802,0.077331019
19107,1265,3385,4858,0.260395224,0.696788802,2120,-0.436393578,IA,Keokuk County,,5221,2298,2840,0.440145566,0.543957096,542,-0.10381153
19109,2529,5637,8505,0.297354497,0.662786596,3108,-0.365432099,IA,Kossuth County,,8833,3824,4914,0.432921997,0.55632288,1090,-0.123400883
19111,6195,8762,15893,0.389794249,0.551311898,2567,-0.161517649,IA,Lee County,,16488,9428,6787,0.571809801,0.411632703,2641,0.160177098
19113,58481,48183,114664,0.510020582,0.420210354,10298,0.089810228,IA,Linn County,,117122,68028,47427,0.580830245,0.404936733,20601,0.175893513
19115,1643,3060,4943,0.332389237,0.619057253,1417,-0.286668015,IA,Louisa County,,4921,2449,2416,0.497663077,0.490957123,33,0.006705954
19117,1236,2873,4297,0.287642541,0.668606004,1637,-0.380963463,IA,Lucas County,,4273,1977,2248,0.462672595,0.526094079,271,-0.063421484
19119,917,5188,6336,0.144728535,0.818813131,4271,-0.674084596,IA,Lyon County,,6466,1416,4965,0.218991649,0.767862666,3549,-0.548871018
19121,2666,5336,8523,0.312800657,0.626070632,2670,-0.313269975,IA,Madison County,,8140,3508,4492,0.430958231,0.551842752,984,-0.120884521
19123,2606,7404,10494,0.24833238,0.705546026,4798,-0.457213646,IA,Mahaska County,,10777,4207,6420,0.390368377,0.595713093,2213,-0.205344716
19125,5469,10940,17554,0.311552922,0.623219779,5471,-0.311666857,IA,Marion County,,17536,7478,9810,0.426437044,0.55942062,2332,-0.132983577
19127,7623,9125,17700,0.430677966,0.515536723,1502,-0.084858757,IA,Marshall County,,18727,10085,8411,0.53852726,0.449137609,1674,0.089389651
19129,2080,5050,7608,0.273396425,0.663774974,2970,-0.390378549,IA,Mills County,,7169,2842,4211,0.39642907,0.587390152,1369,-0.190961082
19131,1879,3180,5360,0.350559701,0.593283582,1301,-0.242723881,IA,Mitchell County,,5580,2831,2643,0.50734767,0.473655914,188,0.033691756
19133,1244,3115,4525,0.274917127,0.68839779,1871,-0.413480663,IA,Monona County,,4707,2098,2555,0.445719142,0.542808583,457,-0.097089441
19135,1053,2635,3844,0.273933403,0.685483871,1582,-0.411550468,IA,Monroe County,,3802,1729,2022,0.454760652,0.531825355,293,-0.077064703
19137,1312,3431,4998,0.262505002,0.68647459,2119,-0.423969588,IA,Montgomery County,,5000,1919,2999,0.3838,0.5998,1080,-0.216
19139,8284,9549,19086,0.434035419,0.500314367,1265,-0.066278948,IA,Muscatine County,,19726,11213,8152,0.568437595,0.413261685,3061,0.15517591
19141,1314,5735,7348,0.17882417,0.780484486,4421,-0.601660316,IA,O'Brien County,,7295,1964,5259,0.269225497,0.720904729,3295,-0.451679232
19143,552,2528,3197,0.172661871,0.79074132,1976,-0.618079449,IA,Osceola County,,3179,909,2225,0.285938975,0.699905631,1316,-0.413966656
19145,1801,4875,6968,0.258467279,0.699626866,3074,-0.441159587,IA,Page County,,7014,2588,4338,0.368976333,0.618477331,1750,-0.249500998
19147,1395,3079,4674,0.298459564,0.658750535,1684,-0.360290971,IA,Palo Alto County,,4857,2124,2649,0.43730698,0.545398394,525,-0.108091414
19149,2878,9659,13057,0.220418167,0.739756452,6781,-0.519338286,IA,Plymouth County,,12909,4148,8577,0.321326207,0.664420172,4429,-0.343093965
19151,962,2692,3831,0.251109371,0.702688593,1730,-0.451579222,IA,Pocahontas County,,3992,1518,2388,0.380260521,0.598196393,870,-0.217935872
19153,119671,93421,228420,0.523907714,0.408987829,26250,0.114919884,IA,Polk County,,227563,128264,96029,0.563641717,0.421988636,32235,0.141653081
19155,15341,24441,42226,0.363306967,0.578814001,9100,-0.215507034,IA,Pottawattamie County,,41679,19347,21751,0.4641906,0.521869527,2404,-0.057678927
19157,4272,4936,9693,0.440730424,0.509233467,664,-0.068503043,IA,Poweshiek County,,9858,5307,4409,0.538344492,0.447250964,898,0.091093528
19159,753,1820,2684,0.280551416,0.678092399,1067,-0.397540984,IA,Ringgold County,,2578,1181,1366,0.45810706,0.529868115,185,-0.071761055
19161,1269,3692,5158,0.246025591,0.715781311,2423,-0.469755719,IA,Sac County,,5256,2117,3086,0.402777778,0.587138508,969,-0.184360731
19163,40302,39083,84878,0.474822687,0.460460897,1219,0.01436179,IA,Scott County,,89826,50581,38223,0.563099771,0.425522677,12358,0.137577093
19165,1649,4340,6270,0.262998405,0.692185008,2691,-0.429186603,IA,Shelby County,,6456,2468,3903,0.38228005,0.604553903,1435,-0.222273854
19167,2289,14761,17989,0.127244427,0.820557007,12472,-0.69331258,IA,Sioux County,,17181,2683,14361,0.156160875,0.8358652,11678,-0.679704325
19169,25085,19111,48910,0.512880801,0.39073809,5974,0.122142711,IA,Story County,,46529,25940,19557,0.557501773,0.420318511,6383,0.137183262
19171,3194,4968,8636,0.369847151,0.575266327,1774,-0.205419176,IA,Tama County,,8930,4737,4076,0.530459127,0.45643897,661,0.074020157
19173,755,2108,3003,0.251415251,0.701964702,1353,-0.450549451,IA,Taylor County,,2978,1261,1680,0.423438549,0.564137005,419,-0.140698455
19175,1920,3521,5768,0.332871012,0.610436893,1601,-0.277565881,IA,Union County,,5899,3029,2800,0.51347686,0.474656721,229,0.038820139
19177,843,2524,3526,0.239081112,0.715825298,1681,-0.476744186,IA,Van Buren County,,3540,1398,2058,0.394915254,0.581355932,660,-0.186440678
19179,5591,8710,14996,0.372832755,0.580821552,3119,-0.207988797,IA,Wapello County,,15630,8616,6777,0.551247601,0.433589251,1839,0.117658349
19181,10371,14773,26916,0.385309853,0.548855699,4402,-0.163545846,IA,Warren County,,25875,12521,13031,0.483903382,0.503613527,510,-0.019710145
19183,3938,6170,10824,0.363821138,0.570029564,2232,-0.206208426,IA,Washington County,,10880,5081,5540,0.467003676,0.509191176,459,-0.0421875
19185,719,2069,2921,0.246148579,0.708319069,1350,-0.46217049,IA,Wayne County,,2886,1251,1583,0.433471933,0.548510049,332,-0.115038115
19187,6293,10049,17239,0.365044376,0.582922443,3756,-0.217878067,IA,Webster County,,18118,9458,8453,0.522022298,0.4665526,1005,0.055469699
19189,1920,3437,5717,0.335840476,0.601189435,1517,-0.265348959,IA,Winnebago County,,5878,2895,2897,0.492514461,0.492854712,2,-0.000340252
19191,5238,5332,11217,0.466969778,0.475349915,94,-0.008380137,IA,Winneshiek County,,11016,6245,4618,0.566902687,0.419208424,1627,0.147694263
19193,16102,24627,42933,0.375049496,0.573614702,8525,-0.198565206,IA,Woodbury County,,44702,22026,22136,0.492729632,0.495190372,110,-0.00246074
19195,1523,2443,4216,0.361242884,0.579459203,920,-0.218216319,IA,Worth County,,4143,2343,1743,0.565532223,0.420709631,600,0.144822592
19197,1890,3790,5949,0.317700454,0.637081862,1900,-0.319381409,IA,Wright County,,6174,2794,3309,0.452542922,0.53595724,515,-0.083414318
20001,1398,3575,5314,0.26307866,0.672751223,2177,-0.409672563,KS,Allen County,,5221,1842,3261,0.352805976,0.62459299,1419,-0.271787014
20003,665,2386,3277,0.202929509,0.728104974,1721,-0.525175465,KS,Anderson County,,3274,937,2246,0.286194258,0.686010996,1309,-0.399816738
20005,1946,3977,6393,0.304395433,0.622086657,2031,-0.317691225,KS,Atchison County,,6499,2486,3836,0.382520388,0.590244653,1350,-0.207724265
20007,281,1822,2209,0.127206881,0.824807605,1541,-0.697600724,KS,Barber County,,2282,473,1753,0.207274321,0.768185802,1280,-0.560911481
20009,1823,7766,10088,0.180709754,0.769825535,5943,-0.589115781,KS,Barton County,,12010,2693,9132,0.224229808,0.760366361,6439,-0.536136553
20011,1306,4314,5918,0.220682663,0.728962487,3008,-0.508279824,KS,Bourbon County,,6118,1951,4022,0.318895064,0.657404381,2071,-0.338509317
20013,850,2861,3960,0.214646465,0.722474747,2011,-0.507828283,KS,Brown County,,3865,1039,2738,0.268822768,0.708408797,1699,-0.439586028
20015,6489,18781,27051,0.239880226,0.694281173,12292,-0.454400946,KS,Butler County,,25452,7124,17764,0.279899419,0.697941223,10640,-0.418041804
20017,313,964,1342,0.233233979,0.718330849,651,-0.48509687,KS,Chase County,,1233,343,857,0.278183293,0.695052717,514,-0.416869424
20019,236,1552,1845,0.127913279,0.841192412,1316,-0.713279133,KS,Chautauqua County,,1502,259,1201,0.172436751,0.799600533,942,-0.627163782
20021,1959,6017,8386,0.233603625,0.717505366,4058,-0.483901741,KS,Cherokee County,,8396,2868,5345,0.341591234,0.636612673,2477,-0.295021439
20023,188,1172,1409,0.133427963,0.8317956,984,-0.698367637,KS,Cheyenne County,,1422,231,1157,0.162447257,0.813642757,926,-0.651195499
20025,118,813,983,0.120040692,0.82706002,695,-0.707019329,KS,Clark County,,1000,171,791,0.171,0.791,620,-0.62
20027,665,2831,3727,0.17842769,0.759592165,2166,-0.581164475,KS,Clay County,,3584,811,2715,0.226283482,0.757533482,1904,-0.53125
20029,744,2856,3831,0.194205168,0.745497259,2112,-0.551292091,KS,Cloud County,,3957,951,2886,0.240333586,0.729340409,1935,-0.489006823
20031,719,2990,3962,0.181474003,0.754669359,2271,-0.573195356,KS,Coffey County,,3839,884,2860,0.230268299,0.744985673,1976,-0.514717374
20033,102,705,857,0.119019837,0.822637106,603,-0.70361727,KS,Comanche County,,915,141,756,0.154098361,0.826229508,615,-0.672131148
20035,3436,8016,12171,0.28231041,0.65861474,4580,-0.37630433,KS,Cowley County,,12444,4219,7932,0.339038894,0.637415622,3713,-0.298376728
20037,5064,8394,14404,0.351569009,0.58275479,3330,-0.231185782,KS,Crawford County,,14385,6545,7480,0.454987835,0.519986097,935,-0.064998262
20039,178,1220,1460,0.121917808,0.835616438,1042,-0.71369863,KS,Decatur County,,1533,266,1219,0.173515982,0.795172864,953,-0.621656882
20041,1582,5905,8008,0.197552448,0.737387612,4323,-0.539835165,KS,Dickinson County,,7854,1962,5709,0.249809015,0.726890756,3747,-0.477081742
20043,584,2601,3366,0.173499703,0.772727273,2017,-0.59922757,KS,Doniphan County,,3369,885,2397,0.262689225,0.711487088,1512,-0.448797863
20045,30089,14308,48231,0.623851879,0.296655678,15781,0.327196202,KS,Douglas County,,46283,28012,17028,0.605233023,0.367910464,10984,0.237322559
20047,208,1033,1308,0.159021407,0.789755352,825,-0.630733945,KS,Edwards County,,1365,291,1048,0.213186813,0.767765568,757,-0.554578755
20049,160,1048,1259,0.127084988,0.832406672,888,-0.705321684,KS,Elk County,,1356,277,1040,0.204277286,0.766961652,763,-0.562684366
20051,2669,8311,11660,0.22890223,0.712778731,5642,-0.483876501,KS,Ellis County,,12779,3464,9057,0.271069724,0.708740903,5593,-0.437671179
20053,515,1933,2626,0.196115765,0.736100533,1418,-0.539984768,KS,Ellsworth County,,2677,696,1905,0.259992529,0.711617482,1209,-0.451624953
20055,3006,6155,9731,0.30890967,0.632514644,3149,-0.323604974,KS,Finney County,,7593,2307,5108,0.303832477,0.672724878,2801,-0.368892401
20057,2032,4994,7425,0.273670034,0.672592593,2962,-0.398922559,KS,Ford County,,8082,2468,5459,0.305369958,0.675451621,2991,-0.370081663
20059,2829,7025,10658,0.265434415,0.659129293,4196,-0.393694877,KS,Franklin County,,10806,3611,6893,0.334166204,0.637886359,3282,-0.303720155
20061,2569,4116,7129,0.360359097,0.577360079,1547,-0.217000982,KS,Geary County,,7526,3158,4242,0.419612012,0.563646027,1084,-0.144034015
20063,149,1127,1328,0.112198795,0.848644578,978,-0.736445783,KS,Gove County,,1368,174,1155,0.127192982,0.844298246,981,-0.717105263
20065,185,1013,1265,0.146245059,0.800790514,828,-0.654545455,KS,Graham County,,1319,248,1044,0.188021228,0.791508719,796,-0.603487491
20067,427,1755,2311,0.184768498,0.75941151,1328,-0.574643012,KS,Grant County,,2215,437,1742,0.197291196,0.786455982,1305,-0.589164786
20069,257,1651,2011,0.127797116,0.820984585,1394,-0.693187469,KS,Gray County,,1901,304,1568,0.159915834,0.824829037,1264,-0.664913204
20071,83,523,639,0.129890454,0.818466354,440,-0.6885759,KS,Greeley County,,665,112,539,0.168421053,0.810526316,427,-0.642105263
20073,484,2146,2811,0.172180719,0.763429385,1662,-0.591248666,KS,Greenwood County,,2706,653,1986,0.241315595,0.733924612,1333,-0.492609017
20075,114,690,847,0.13459268,0.814639906,576,-0.680047226,KS,Hamilton County,,857,159,678,0.185530922,0.791131855,519,-0.605600933
20077,388,1950,2513,0.154397135,0.775964982,1562,-0.621567847,KS,Harper County,,2335,536,1723,0.229550321,0.737901499,1187,-0.508351178
20079,5006,8503,14540,0.344291609,0.58480055,3497,-0.240508941,KS,Harvey County,,13805,5162,8352,0.373922492,0.604998189,3190,-0.231075697
20081,228,1011,1300,0.175384615,0.777692308,783,-0.602307692,KS,Haskell County,,1355,202,1131,0.149077491,0.834686347,929,-0.685608856
20083,124,845,1006,0.123260437,0.839960239,721,-0.716699801,KS,Hodgeman County,,1050,178,857,0.16952381,0.816190476,679,-0.646666667
20085,1489,3888,5727,0.259996508,0.678889471,2399,-0.418892963,KS,Jackson County,,5474,1870,3476,0.341614907,0.635001827,1606,-0.29338692
20087,2483,5112,8151,0.304625199,0.627162311,2629,-0.322537112,KS,Jefferson County,,7725,2883,4647,0.373203883,0.601553398,1764,-0.228349515
20089,180,1204,1483,0.12137559,0.811867835,1024,-0.690492245,KS,Jewell County,,1477,225,1220,0.152335816,0.825998646,995,-0.67366283
20091,126324,133907,279753,0.451555479,0.478661534,7583,-0.027106054,KS,Johnson County,,268145,107651,155442,0.401465625,0.579693822,47791,-0.178228197
20093,224,1048,1325,0.169056604,0.790943396,824,-0.621886792,KS,Kearny County,,1341,261,1060,0.194630872,0.790454884,799,-0.595824012
20095,594,2507,3281,0.181042365,0.764096312,1913,-0.583053947,KS,Kingman County,,3199,731,2371,0.228508909,0.741169115,1640,-0.512660206
20097,111,855,1023,0.108504399,0.835777126,744,-0.727272727,KS,Kiowa County,,1133,160,970,0.141218005,0.856134157,810,-0.714916152
20099,2234,5232,7919,0.282106327,0.660689481,2998,-0.378583154,KS,Labette County,,7907,3074,4668,0.388769445,0.59036297,1594,-0.201593525
20101,104,684,831,0.125150421,0.823104693,580,-0.697954272,KS,Lane County,,917,170,732,0.185387132,0.79825518,562,-0.612868048
20103,10064,17387,29676,0.339129263,0.585894325,7323,-0.246765063,KS,Leavenworth County,,28532,11072,16825,0.388055517,0.589688771,5753,-0.201633254
20105,214,1168,1448,0.147790055,0.806629834,954,-0.658839779,KS,Lincoln County,,1459,284,1148,0.194653873,0.786840302,864,-0.592186429
20107,721,3377,4279,0.168497312,0.789203085,2656,-0.620705772,KS,Linn County,,4294,1108,3079,0.258034467,0.717047042,1971,-0.459012576
20109,149,1124,1348,0.110534125,0.833827893,975,-0.723293769,KS,Logan County,,1302,194,1084,0.149001536,0.832565284,890,-0.683563748
20111,4456,6354,11745,0.379395487,0.540996169,1898,-0.161600681,KS,Lyon County,,11614,4972,6358,0.428104012,0.547442742,1386,-0.119338729
20113,3183,8407,12443,0.255806478,0.675640923,5224,-0.419834445,KS,McPherson County,,12060,3384,8399,0.280597015,0.696434494,5015,-0.415837479
20115,1177,3928,5465,0.21537054,0.718755718,2751,-0.503385178,KS,Marion County,,5368,1371,3865,0.255402385,0.720007452,2494,-0.464605067
20117,1060,3250,4578,0.231542158,0.709916994,2190,-0.478374836,KS,Marshall County,,4679,1451,3123,0.310108998,0.66745031,1672,-0.357341312
20119,206,1390,1675,0.122985075,0.829850746,1184,-0.706865672,KS,Meade County,,1648,254,1394,0.154126214,0.845873786,1140,-0.691747573
20121,3949,9839,14712,0.268420337,0.66877379,5890,-0.400353453,KS,Miami County,,14642,4635,9726,0.316555115,0.664253517,5091,-0.347698402
20123,469,2216,2824,0.166076487,0.78470255,1747,-0.618626062,KS,Mitchell County,,2923,576,2293,0.197057817,0.784468012,1717,-0.587410195
20125,2557,8466,11623,0.219994838,0.728383378,5909,-0.50838854,KS,Montgomery County,,12093,3406,8417,0.281650542,0.696022492,5011,-0.414371951
20127,586,1790,2568,0.228193146,0.697040498,1204,-0.468847352,KS,Morris County,,2526,705,1750,0.279097387,0.692794933,1045,-0.413697546
20129,145,970,1160,0.125,0.836206897,825,-0.711206897,KS,Morton County,,1247,180,1050,0.144346431,0.84202085,870,-0.697674419
20131,714,4066,5025,0.142089552,0.809154229,3352,-0.667064677,KS,Nemaha County,,4959,988,3878,0.199233716,0.782012503,2890,-0.582778786
20133,1464,4340,6151,0.23801008,0.705576329,2876,-0.467566249,KS,Neosho County,,6359,2012,4193,0.31640195,0.659380406,2181,-0.342978456
20135,160,1216,1435,0.111498258,0.84738676,1056,-0.735888502,KS,Ness County,,1417,211,1190,0.14890614,0.839802399,979,-0.69089626
20137,277,1808,2190,0.126484018,0.825570776,1531,-0.699086758,KS,Norton County,,2296,393,1855,0.171167247,0.807926829,1462,-0.636759582
20139,1730,4713,6894,0.250942849,0.683637946,2983,-0.432695097,KS,Osage County,,6771,2228,4336,0.329050362,0.640378083,2108,-0.311327721
20141,231,1437,1753,0.131774102,0.819737593,1206,-0.687963491,KS,Osborne County,,1802,320,1448,0.177580466,0.803551609,1128,-0.625971143
20143,424,2261,2866,0.147941382,0.788904396,1837,-0.640963015,KS,Ottawa County,,2888,548,2260,0.189750693,0.782548476,1712,-0.592797784
20145,567,1872,2602,0.217909301,0.71944658,1305,-0.501537279,KS,Pawnee County,,2565,704,1808,0.274463938,0.704873294,1104,-0.430409357
20147,296,2200,2611,0.113366526,0.842589046,1904,-0.72922252,KS,Phillips County,,2537,376,2116,0.148206543,0.834055972,1740,-0.685849428
20149,2191,7451,10359,0.211506902,0.719277923,5260,-0.50777102,KS,Pottawatomie County,,9303,2291,6692,0.246264646,0.719337848,4401,-0.473073202
20151,769,2824,3806,0.202049396,0.741986337,2055,-0.539936942,KS,Pratt County,,3752,974,2730,0.259594883,0.72761194,1756,-0.468017058
20153,160,1209,1448,0.110497238,0.834944751,1049,-0.724447514,KS,Rawlins County,,1420,184,1207,0.129577465,0.85,1023,-0.720422535
20155,6670,15100,23448,0.284459229,0.643978164,8430,-0.359518936,KS,Reno County,,23869,7888,15398,0.330470485,0.645104529,7510,-0.314634044
20157,370,1993,2484,0.148953301,0.802334944,1623,-0.653381643,KS,Republic County,,2640,470,2098,0.178030303,0.79469697,1628,-0.616666667
20159,668,2652,3567,0.187272218,0.743481918,1984,-0.5562097,KS,Rice County,,3622,899,2631,0.248205411,0.726394257,1732,-0.478188846
20161,8892,9817,20475,0.434285714,0.479462759,925,-0.045177045,KS,Riley County,,20266,8587,11157,0.423714596,0.550527978,2570,-0.126813382
20163,273,1999,2378,0.114802355,0.840622372,1726,-0.725820017,KS,Rooks County,,2625,398,2159,0.151619048,0.82247619,1761,-0.670857143
20165,227,1177,1474,0.154002714,0.798507463,950,-0.644504749,KS,Rush County,,1549,361,1151,0.233053583,0.743060039,790,-0.510006456
20167,454,2544,3148,0.144218551,0.808132147,2090,-0.663913596,KS,Russell County,,3140,584,2505,0.185987261,0.797770701,1921,-0.611783439
20169,6084,13367,21206,0.286899934,0.63034047,7283,-0.343440536,KS,Saline County,,21102,6910,13697,0.327457113,0.649085395,6787,-0.321628282
20171,232,1832,2159,0.107457156,0.848540991,1600,-0.741083835,KS,Scott County,,2019,271,1702,0.134224864,0.84299158,1431,-0.708766716
20173,66716,101319,180750,0.369106501,0.560547718,34603,-0.191441217,KS,Sedgwick County,,177852,69373,104411,0.390060275,0.587066775,35038,-0.1970065
20175,1491,3025,4743,0.314358001,0.637781995,1534,-0.323423993,KS,Seward County,,4955,1393,3495,0.281130172,0.705348133,2102,-0.424217962
20177,33270,35349,73648,0.451743428,0.479972301,2079,-0.028228872,KS,Shawnee County,,74844,35959,37226,0.480452675,0.49738122,1267,-0.016928545
20179,126,1186,1362,0.092511013,0.870778267,1060,-0.778267254,KS,Sheridan County,,1320,165,1136,0.125,0.860606061,971,-0.735606061
20181,340,2043,2537,0.134016555,0.805281829,1703,-0.671265274,KS,Sherman County,,2606,575,1967,0.220644666,0.754796623,1392,-0.534151957
20183,295,1635,2014,0.146474677,0.811817279,1340,-0.665342602,KS,Smith County,,1983,345,1598,0.17397882,0.805849723,1253,-0.631870903
20185,303,1485,1884,0.160828025,0.788216561,1182,-0.627388535,KS,Stafford County,,1833,403,1382,0.219858156,0.753955265,979,-0.534097109
20187,132,580,742,0.177897574,0.781671159,448,-0.603773585,KS,Stanton County,,713,135,571,0.189340813,0.800841515,436,-0.611500701
20189,215,1564,1853,0.116028063,0.844036697,1349,-0.728008635,KS,Stevens County,,1998,241,1724,0.120620621,0.862862863,1483,-0.742242242
20191,2039,6844,9494,0.214767221,0.720876343,4805,-0.506109122,KS,Sumner County,,8989,2617,6162,0.291133608,0.685504506,3545,-0.394370898
20193,467,2832,3483,0.134079816,0.813092162,2365,-0.679012346,KS,Thomas County,,3388,576,2729,0.170011806,0.805489965,2153,-0.635478158
20195,193,1211,1459,0.132282385,0.830020562,1018,-0.697738177,KS,Trego County,,1544,289,1230,0.187176166,0.796632124,941,-0.609455959
20197,773,2358,3340,0.231437126,0.705988024,1585,-0.474550898,KS,Wabaunsee County,,3229,908,2230,0.28120161,0.69061629,1322,-0.409414679
20199,45,711,779,0.057766367,0.912708601,666,-0.854942234,KS,Wallace County,,781,68,702,0.087067862,0.898847631,634,-0.81177977
20201,378,2136,2677,0.141202839,0.797908106,1758,-0.656705267,KS,Washington County,,2863,515,2300,0.179881243,0.803353126,1785,-0.623471883
20203,139,765,934,0.14882227,0.819057816,626,-0.670235546,KS,Wichita County,,987,157,821,0.159067882,0.831813576,664,-0.672745694
20205,550,2747,3482,0.157955198,0.788914417,2197,-0.630959219,KS,Wilson County,,3699,813,2812,0.219789132,0.760205461,1999,-0.540416329
20207,270,1063,1420,0.190140845,0.748591549,793,-0.558450704,KS,Woodson County,,1435,377,1030,0.26271777,0.717770035,653,-0.455052265
20209,29346,15520,47467,0.61824004,0.326963996,13826,0.291276044,KS,Wyandotte County,,49422,33265,15273,0.673080814,0.309032415,17992,0.364048399
21001,1323,6637,8228,0.160792416,0.806635877,5314,-0.645843461,KY,Adair County,,7600,1660,5841,0.218421053,0.768552632,4181,-0.550131579
21003,1349,6466,8085,0.166852195,0.799752628,5117,-0.632900433,KY,Allen County,,7099,1808,5184,0.254683758,0.730243696,3376,-0.475559938
21005,2634,8242,11414,0.230769231,0.722095672,5608,-0.491326441,KY,Anderson County,,10318,3315,6822,0.321283194,0.661174646,3507,-0.339891452
21007,816,3161,4097,0.199170124,0.771540151,2345,-0.572370027,KY,Ballard County,,3895,1189,2647,0.305263158,0.679589217,1458,-0.374326059
21009,4275,13483,18473,0.231418827,0.729876035,9208,-0.498457208,KY,Barren County,,16565,5400,10922,0.32598853,0.659341986,5522,-0.333353456
21011,1361,3082,4577,0.297356347,0.673366834,1721,-0.376010487,KY,Bath County,,4122,1770,2275,0.429403202,0.551916545,505,-0.122513343
21013,1720,7764,9714,0.177064031,0.799258802,6044,-0.62219477,KY,Bell County,,9482,2224,7127,0.234549673,0.751634676,4903,-0.517085003
21015,15026,39082,57550,0.2610947,0.679096438,24056,-0.418001738,KY,Boone County,,52495,15628,35920,0.297704543,0.684255643,20292,-0.3865511
21017,2791,5569,8791,0.31748379,0.633488795,2778,-0.316005005,KY,Bourbon County,,7909,3075,4692,0.388797572,0.593248198,1617,-0.204450626
21019,6021,13591,20443,0.294526244,0.664824145,7570,-0.370297901,KY,Boyd County,,19040,7776,10883,0.408403361,0.571586134,3107,-0.163182773
21021,4281,8040,12928,0.331141708,0.621905941,3759,-0.290764233,KY,Boyle County,,12368,4471,7703,0.361497413,0.622816947,3232,-0.261319534
21023,705,2711,3522,0.200170358,0.769733106,2006,-0.569562748,KY,Bracken County,,3230,1147,2029,0.355108359,0.628173375,882,-0.273065015
21025,1537,3991,5728,0.268331006,0.696752793,2454,-0.428421788,KY,Breathitt County,,5008,1562,3318,0.311900958,0.662539936,1756,-0.350638978
21027,1960,6484,8765,0.223616657,0.739760411,4524,-0.516143754,KY,Breckinridge County,,7967,2825,5025,0.354587674,0.630726748,2200,-0.276139074
21029,8255,26210,36036,0.229076479,0.727328227,17955,-0.498251748,KY,Bullitt County,,31775,9971,21306,0.313800157,0.670527144,11335,-0.356726987
21031,947,4428,5575,0.169865471,0.79426009,3481,-0.624394619,KY,Butler County,,5058,1293,3716,0.255634638,0.734677738,2423,-0.4790431
21033,1260,4507,5972,0.210984595,0.754688547,3247,-0.543703952,KY,Caldwell County,,5860,1852,3904,0.316040956,0.666211604,2052,-0.350170648
21035,4749,10367,16039,0.296090779,0.646361993,5618,-0.350271214,KY,Calloway County,,15064,5314,9438,0.352761551,0.626526819,4124,-0.273765268
21037,14658,25050,42471,0.345129618,0.589814226,10392,-0.244684608,KY,Campbell County,,40173,15080,24240,0.375376497,0.603390337,9160,-0.22801384
21039,432,2094,2599,0.166217776,0.805694498,1662,-0.639476722,KY,Carlisle County,,2619,750,1835,0.286368843,0.700649103,1085,-0.41428026
21041,1106,2588,3851,0.28719813,0.672033238,1482,-0.384835108,KY,Carroll County,,3680,1629,1999,0.442663043,0.543206522,370,-0.100543478
21043,2276,7587,10267,0.221681114,0.738969514,5311,-0.5172884,KY,Carter County,,8906,3383,5279,0.379856277,0.592746463,1896,-0.212890186
21045,767,5482,6438,0.119136378,0.851506679,4715,-0.732370301,KY,Casey County,,6091,1086,4904,0.178295846,0.805122312,3818,-0.626826465
21047,7188,14108,22069,0.325705741,0.639267751,6920,-0.31356201,KY,Christian County,,21953,8252,13475,0.375893955,0.613811324,5223,-0.237917369
21049,4706,10710,16193,0.290619403,0.6613969,6004,-0.370777496,KY,Clark County,,15410,5228,9931,0.339260221,0.644451655,4703,-0.305191434
21051,752,5861,6762,0.111209701,0.866755398,5109,-0.755545697,KY,Clay County,,7383,1111,6176,0.150480834,0.836516321,5065,-0.686035487
21053,547,3809,4454,0.122810956,0.855186349,3262,-0.732375393,KY,Clinton County,,4393,752,3569,0.171181425,0.812428864,2817,-0.641247439
21055,617,3290,4036,0.152874133,0.815163528,2673,-0.662289395,KY,Crittenden County,,3854,960,2839,0.249091853,0.73663726,1879,-0.487545407
21057,459,2502,3061,0.149950996,0.817379941,2043,-0.667428945,KY,Cumberland County,,2853,599,2216,0.209954434,0.776726253,1617,-0.566771819
21059,14163,28907,45752,0.309560238,0.631819374,14744,-0.322259136,KY,Daviess County,,42079,16208,25092,0.385180256,0.596306946,8884,-0.21112669
21061,979,4135,5239,0.186867723,0.789272762,3156,-0.602405039,KY,Edmonson County,,4664,1374,3232,0.294596913,0.69296741,1858,-0.398370497
21063,740,2000,2847,0.259922726,0.702493853,1260,-0.442571128,KY,Elliott County,,2399,1186,1126,0.494372655,0.469362234,60,0.025010421
21065,1108,4236,5538,0.200072228,0.764897075,3128,-0.564824847,KY,Estill County,,5184,1356,3749,0.261574074,0.723186728,2393,-0.461612654
21067,69776,56890,136112,0.512636652,0.417964617,12886,0.094672035,KY,Fayette County,,125821,62078,60793,0.493383457,0.483170536,1285,0.010212922
21069,1348,4722,6250,0.21568,0.75552,3374,-0.53984,KY,Fleming County,,5782,1911,3780,0.330508475,0.653753027,1869,-0.323244552
21071,4015,11993,16521,0.24302403,0.725924581,7978,-0.482900551,KY,Floyd County,,14890,4733,9784,0.317864338,0.657085292,5051,-0.339220954
21073,10717,11819,23840,0.449538591,0.495763423,1102,-0.046224832,KY,Franklin County,,23337,11535,11345,0.49427947,0.486137893,190,0.008141578
21075,774,1549,2381,0.325073499,0.650566989,775,-0.32549349,KY,Fulton County,,2481,1022,1425,0.411930673,0.574365175,403,-0.162434502
21077,749,2443,3334,0.224655069,0.732753449,1694,-0.50809838,KY,Gallatin County,,3060,1238,1758,0.404575163,0.574509804,520,-0.169934641
21079,1453,5904,7613,0.190857743,0.775515565,4451,-0.584657822,KY,Garrard County,,7077,1661,5310,0.234703971,0.750317931,3649,-0.515613961
21081,1910,7268,9551,0.19997906,0.760967438,5358,-0.560988378,KY,Grant County,,8606,2810,5664,0.326516384,0.65814548,2854,-0.331629096
21083,3308,12671,16582,0.199493427,0.764141841,9363,-0.564648414,KY,Graves County,,15493,4547,10699,0.293487381,0.690569935,6152,-0.397082553
21085,1959,8219,10564,0.185441121,0.77801969,6260,-0.592578569,KY,Grayson County,,9269,2744,6404,0.296040565,0.690905168,3660,-0.394864602
21087,832,4372,5331,0.15606828,0.820108798,3540,-0.664040518,KY,Green County,,4856,1165,3634,0.23990939,0.748352554,2469,-0.508443163
21089,4146,11546,16265,0.254903166,0.709867814,7400,-0.454964648,KY,Greenup County,,15159,6027,8855,0.397585593,0.584141434,2828,-0.186555841
21091,1244,2788,4292,0.289841566,0.649580615,1544,-0.359739049,KY,Hancock County,,4133,1833,2212,0.443503508,0.535204452,379,-0.091700944
21093,13944,26970,43113,0.323429128,0.625565375,13026,-0.302136247,KY,Hardin County,,39212,15214,23357,0.387993471,0.595659492,8143,-0.207666021
21095,1372,9129,10744,0.127699181,0.849683544,7757,-0.721984363,KY,Harlan County,,10658,1830,8653,0.171702008,0.811878401,6823,-0.640176393
21097,2031,5435,7774,0.261255467,0.699125289,3404,-0.437869822,KY,Harrison County,,7163,2471,4556,0.344967193,0.636046349,2085,-0.291079157
21099,1730,5320,7261,0.238259193,0.732681449,3590,-0.494422256,KY,Hart County,,6621,2283,4256,0.344811962,0.642803202,1973,-0.29799124
21101,6707,12159,19692,0.340595166,0.617458867,5452,-0.276863701,KY,Henderson County,,18614,8091,10296,0.434672827,0.553132051,2205,-0.118459224
21103,1828,4944,7142,0.255950714,0.692243069,3116,-0.436292355,KY,Henry County,,6584,2529,3940,0.384113001,0.598420413,1411,-0.214307412
21105,449,1657,2157,0.208159481,0.768196569,1208,-0.560037089,KY,Hickman County,,2139,686,1431,0.320710612,0.669004208,745,-0.348293595
21107,4310,15277,20325,0.212054121,0.751635916,10967,-0.539581796,KY,Hopkins County,,19765,5789,13681,0.292891475,0.692183152,7892,-0.399291677
21109,482,4889,5497,0.087684191,0.889394215,4407,-0.801710024,KY,Jackson County,,5061,612,4365,0.120924718,0.862477771,3753,-0.741553053
21111,190824,143758,352778,0.540918084,0.407502735,47066,0.133415349,KY,Jefferson County,,339500,186164,148415,0.54834757,0.437157585,37749,0.111189985
21113,6144,15474,23292,0.263781556,0.664348274,9330,-0.400566718,KY,Jessamine County,,20620,6001,14232,0.291028128,0.690203686,8231,-0.399175558
21115,1250,8043,9560,0.130753138,0.841317992,6793,-0.710564854,KY,Johnson County,,9035,1723,7095,0.190702822,0.785279469,5372,-0.594576646
21117,24213,42958,71905,0.336735971,0.597427161,18745,-0.26069119,KY,Kenton County,,67679,24917,41387,0.368164423,0.611519083,16470,-0.243354659
21119,1245,4357,5756,0.216296039,0.75694927,3112,-0.540653231,KY,Knott County,,5693,1420,4130,0.249429123,0.72545231,2710,-0.476023186
21121,1761,9885,12001,0.146737772,0.82368136,8124,-0.676943588,KY,Knox County,,11100,2484,8467,0.223783784,0.762792793,5983,-0.539009009
21123,1278,4799,6359,0.200974996,0.754678409,3521,-0.553703412,KY,Larue County,,5764,1733,3911,0.300659264,0.67852186,2178,-0.377862595
21125,3440,20592,24811,0.13864818,0.829954456,17152,-0.691306275,KY,Laurel County,,22408,3905,18151,0.174268119,0.810023206,14246,-0.635755087
21127,1045,4816,6037,0.173099221,0.797747225,3771,-0.624648004,KY,Lawrence County,,5592,1520,3995,0.271816881,0.714413448,2475,-0.442596567
21129,444,2151,2663,0.166729253,0.807735637,1707,-0.641006384,KY,Lee County,,2623,595,1977,0.226839497,0.753717118,1382,-0.526877621
21131,400,4015,4487,0.089146423,0.894807221,3615,-0.805660798,KY,Leslie County,,4950,433,4439,0.087474747,0.896767677,4006,-0.809292929
21133,1542,7293,9131,0.16887526,0.798707699,5751,-0.629832439,KY,Letcher County,,8758,1702,6811,0.194336607,0.77768897,5109,-0.583352364
21135,785,4363,5293,0.148309087,0.82429624,3578,-0.675987153,KY,Lewis County,,4769,1342,3326,0.281400713,0.697420843,1984,-0.41602013
21137,1865,7338,9555,0.195185767,0.767974882,5473,-0.572789116,KY,Lincoln County,,9152,2582,6416,0.282124126,0.701048951,3834,-0.418924825
21139,887,3570,4642,0.19108143,0.769065058,2683,-0.577983628,KY,Livingston County,,4511,1346,3089,0.298381734,0.684770561,1743,-0.386388827
21141,2755,7778,10896,0.252845081,0.713839941,5023,-0.46099486,KY,Logan County,,10509,3469,6899,0.330098011,0.656484918,3430,-0.326386906
21143,1045,2789,3959,0.263955544,0.704470826,1744,-0.440515282,KY,Lyon County,,3838,1373,2412,0.357738405,0.628452319,1039,-0.270713913
21145,9134,20774,31284,0.291970336,0.664045518,11640,-0.372075182,KY,McCracken County,,30540,10062,19979,0.329469548,0.654191225,9917,-0.324721676
21147,664,5012,5772,0.115038115,0.868329868,4348,-0.753291753,KY,McCreary County,,5704,1069,4564,0.187412342,0.800140252,3495,-0.61272791
21149,988,3381,4565,0.216429354,0.740635268,2393,-0.524205915,KY,McLean County,,4200,1432,2705,0.340952381,0.644047619,1273,-0.303095238
21151,11793,23431,37318,0.31601372,0.627873948,11638,-0.311860228,KY,Madison County,,33317,11512,21128,0.345529309,0.634150734,9616,-0.288621424
21153,1172,3824,5113,0.229219636,0.747897516,2652,-0.51867788,KY,Magoffin County,,4905,1433,3391,0.292150866,0.691335372,1958,-0.399184506
21155,2679,5122,8108,0.330414406,0.631721756,2443,-0.301307351,KY,Marion County,,7316,3418,3800,0.467195189,0.519409513,382,-0.052214325
21157,3672,12322,16678,0.220170284,0.738817604,8650,-0.51864732,KY,Marshall County,,15714,5022,10402,0.319587629,0.66195749,5380,-0.342369861
21159,363,3503,3951,0.091875475,0.886610985,3140,-0.79473551,KY,Martin County,,3824,574,3180,0.150104603,0.831589958,2606,-0.681485356
21161,1970,4944,7212,0.273155851,0.685524126,2974,-0.412368275,KY,Mason County,,6879,2592,4197,0.376798953,0.61011775,1605,-0.233318796
21163,3026,8660,12223,0.247566064,0.708500368,5634,-0.460934304,KY,Meade County,,10915,4122,6606,0.377645442,0.605222171,2484,-0.227576729
21165,700,2010,2779,0.251889169,0.723281756,1310,-0.471392587,KY,Menifee County,,2598,1048,1484,0.403387221,0.571208622,436,-0.167821401
21167,2395,7740,10579,0.226391908,0.731638151,5345,-0.505246243,KY,Mercer County,,9936,2966,6820,0.298510467,0.686392915,3854,-0.387882448
21169,976,3491,4616,0.211438475,0.756282496,2515,-0.544844021,KY,Metcalfe County,,4184,1425,2676,0.340583174,0.63957935,1251,-0.298996176
21171,601,4278,4991,0.12041675,0.857142857,3677,-0.736726107,KY,Monroe County,,4746,936,3762,0.19721871,0.792667509,2826,-0.595448799
21173,3158,7856,11437,0.27612136,0.686893416,4698,-0.410772056,KY,Montgomery County,,10248,3701,6398,0.361143638,0.62431694,2697,-0.263173302
21175,1006,3628,4766,0.211078473,0.761225346,2622,-0.550146874,KY,Morgan County,,4472,1369,3021,0.306127013,0.675536673,1652,-0.36940966
21177,3272,9393,13046,0.250804844,0.719990802,6121,-0.469185957,KY,Muhlenberg County,,12737,4771,7762,0.374578001,0.609405669,2991,-0.234827667
21179,6434,13430,20761,0.309908001,0.646885988,6996,-0.336977988,KY,Nelson County,,18532,7611,10673,0.410695014,0.575922728,3062,-0.165227714
21181,787,1957,2837,0.27740571,0.689813183,1170,-0.412407473,KY,Nicholas County,,2580,948,1583,0.36744186,0.613565891,635,-0.246124031
21183,2080,7942,10398,0.200038469,0.763800731,5862,-0.563762262,KY,Ohio County,,9646,2987,6470,0.309662036,0.67074435,3483,-0.361082314
21185,10268,20469,32838,0.312686522,0.623332724,10201,-0.310646203,KY,Oldham County,,29873,9240,20179,0.30930941,0.67549292,10939,-0.36618351
21187,1062,3745,4997,0.212527517,0.74944967,2683,-0.536922153,KY,Owen County,,4555,1501,2971,0.329527991,0.652250274,1470,-0.322722283
21189,256,1474,1757,0.145702903,0.838929994,1218,-0.693227092,KY,Owsley County,,1580,283,1279,0.179113924,0.809493671,996,-0.630379747
21191,1164,4604,6006,0.193806194,0.766566767,3440,-0.572760573,KY,Pendleton County,,5534,1859,3556,0.335923383,0.642573184,1697,-0.306649801
21193,2136,8158,10566,0.202157865,0.772099186,6022,-0.569941321,KY,Perry County,,10240,2047,8040,0.199902344,0.78515625,5993,-0.585253906
21195,4277,19740,24637,0.173600682,0.801233916,15463,-0.627633235,KY,Pike County,,23632,5645,17589,0.238871022,0.744287407,11944,-0.505416385
21197,1272,3513,4952,0.256865913,0.709410339,2241,-0.452544426,KY,Powell County,,4441,1620,2726,0.364782707,0.613825715,1106,-0.249043008
21199,4208,22900,28015,0.150205247,0.81741924,18692,-0.667213993,KY,Pulaski County,,26003,4976,20714,0.191362535,0.796600392,15738,-0.605237857
21201,222,759,1013,0.219151037,0.749259625,537,-0.530108588,KY,Robertson County,,935,340,579,0.363636364,0.619251337,239,-0.255614973
21203,915,5609,6686,0.136853126,0.83891714,4694,-0.702064014,KY,Rockcastle County,,6216,1097,5028,0.176480051,0.808880309,3931,-0.632400257
21205,3295,5174,8829,0.373201948,0.586023332,1879,-0.212821384,KY,Rowan County,,7641,3438,4035,0.449941107,0.528072242,597,-0.078131135
21207,1093,6863,8171,0.133765757,0.839921674,5770,-0.706155917,KY,Russell County,,7907,1445,6346,0.182749463,0.802579992,4901,-0.61983053
21209,7713,15052,24159,0.319259903,0.623039033,7339,-0.30377913,KY,Scott County,,20565,7532,12679,0.366253343,0.616532944,5147,-0.250279601
21211,6276,13196,20563,0.305208384,0.641735155,6920,-0.336526771,KY,Shelby County,,18659,6634,11790,0.355538882,0.63186666,5156,-0.276327777
21213,2144,5077,7524,0.284954811,0.674774056,2933,-0.389819245,KY,Simpson County,,7089,2650,4355,0.373818592,0.614332064,1705,-0.240513472
21215,1921,7196,9509,0.20201914,0.756756757,5275,-0.554737617,KY,Spencer County,,8431,2549,5726,0.302336615,0.679160242,3177,-0.376823627
21217,2553,8320,11301,0.225909212,0.736218034,5767,-0.510308822,KY,Taylor County,,10946,3284,7551,0.300018272,0.689841038,4267,-0.389822766
21219,1042,3612,4771,0.218402851,0.757073989,2570,-0.538671138,KY,Todd County,,4718,1403,3247,0.297371768,0.688215345,1844,-0.390843578
21221,1587,4928,6740,0.235459941,0.73115727,3341,-0.495697329,KY,Trigg County,,6740,2115,4520,0.31379822,0.670623145,2405,-0.356824926
21223,879,2771,3786,0.232171157,0.731907026,1892,-0.499735869,KY,Trimble County,,3540,1355,2133,0.382768362,0.602542373,778,-0.219774011
21225,1331,4701,6209,0.214366243,0.757126751,3370,-0.542760509,KY,Union County,,5975,1941,3952,0.324853556,0.661422594,2011,-0.336569038
21227,16966,28673,48416,0.350421348,0.59222158,11707,-0.241800231,KY,Warren County,,43889,16805,26384,0.382897765,0.601152908,9579,-0.218255144
21229,1420,4013,5621,0.252624088,0.713929906,2593,-0.461305817,KY,Washington County,,5218,1669,3495,0.31985435,0.669796857,1826,-0.349942507
21231,1431,6370,7988,0.179143716,0.797446169,4939,-0.618302454,KY,Wayne County,,7210,1855,5289,0.257281553,0.733564494,3434,-0.47628294
21233,1240,4397,5804,0.213645762,0.757580979,3157,-0.543935217,KY,Webster County,,5470,1765,3607,0.322669104,0.659414991,1842,-0.336745887
21235,2067,11312,13765,0.150163458,0.821794406,9245,-0.671630948,KY,Whitley County,,13068,2683,10232,0.205310683,0.782981328,7549,-0.577670646
21237,753,1804,2634,0.285876993,0.684889901,1051,-0.399012908,KY,Wolfe County,,2559,976,1542,0.381398984,0.602579132,566,-0.221180148
21239,4958,7697,13547,0.365985089,0.568170075,2739,-0.202184986,KY,Woodford County,,12331,4883,7218,0.395993837,0.585353986,2335,-0.189360149
22001,5638,21159,27386,0.205871613,0.772621047,15521,-0.566749434,LA,Acadia Parish,,26834,6559,19931,0.24442871,0.742751733,13372,-0.498323023
22003,2106,6867,9245,0.22779881,0.742779881,4761,-0.514981071,LA,Allen Parish,,9306,2616,6495,0.281108962,0.697936815,3879,-0.416827853
22005,16471,36135,54663,0.301318991,0.661050436,19664,-0.359731445,LA,Ascension Parish,,51056,16343,33846,0.320099499,0.662919148,17503,-0.342819649
22007,3931,6714,10904,0.360509905,0.615737344,2783,-0.255227439,LA,Assumption Parish,,10991,4754,6082,0.432535711,0.553361842,1328,-0.12082613
22009,5032,11163,16581,0.303479887,0.673240456,6131,-0.369760569,LA,Avoyelles Parish,,17027,6075,10667,0.356786281,0.626475598,4592,-0.269689317
22011,2393,12238,15078,0.158708051,0.811646107,9845,-0.652938055,LA,Beauregard Parish,,14223,2827,11111,0.198762568,0.781199466,8284,-0.582436898
22013,3129,3756,7005,0.446680942,0.536188437,627,-0.089507495,LA,Bienville Parish,,7203,3490,3641,0.484520339,0.505483826,151,-0.020963487
22015,12638,35451,49818,0.253683408,0.711610261,22813,-0.457926854,LA,Bossier Parish,,48559,12955,34986,0.266788855,0.720484359,22031,-0.453695504
22017,53448,48977,105737,0.505480579,0.463196421,4471,0.042284158,LA,Caddo Parish,,111516,57879,52378,0.519019692,0.469690448,5501,0.049329244
22019,26293,54182,83773,0.313860074,0.646771633,27889,-0.332911559,LA,Calcasieu Parish,,81718,28357,51844,0.347010451,0.634425708,23487,-0.287415257
22021,788,3822,4692,0.167945439,0.814578005,3034,-0.646632566,LA,Caldwell Parish,,4716,1016,3640,0.215436811,0.771840543,2624,-0.556403732
22023,323,3256,3692,0.087486457,0.881906826,2933,-0.794420368,LA,Cameron Parish,,3744,408,3260,0.108974359,0.870726496,2852,-0.761752137
22025,1322,3479,4856,0.272240527,0.716433278,2157,-0.444192751,LA,Catahoula Parish,,4193,1408,2744,0.335797758,0.65442404,1336,-0.318626282
22027,2717,3585,6421,0.423142813,0.558324249,868,-0.135181436,LA,Claiborne Parish,,6732,3014,3649,0.447712418,0.542038027,635,-0.094325609
22029,3272,5474,8869,0.368925471,0.617205998,2202,-0.248280528,LA,Concordia Parish,,9380,3833,5450,0.408635394,0.581023454,1617,-0.17238806
22031,5163,8067,13497,0.382529451,0.597688375,2904,-0.215158924,LA,De Soto Parish,,13050,5552,7353,0.425440613,0.563448276,1801,-0.138007663
22033,102711,84620,196332,0.523149563,0.431004625,18091,0.092144938,LA,East Baton Rouge Parish,,197912,102460,92235,0.517704839,0.466040462,10225,0.051664376
22035,1838,1059,2939,0.625382783,0.360326642,779,0.265056142,LA,East Carroll Parish,,3384,2244,1122,0.663120567,0.331560284,1122,0.331560284
22037,4235,5569,10042,0.421728739,0.554570803,1334,-0.132842063,LA,East Feliciana Parish,,10209,4648,5397,0.455284553,0.52865119,749,-0.073366637
22039,4208,10357,14879,0.282814705,0.696081726,6149,-0.413267021,LA,Evangeline Parish,,15765,5330,10176,0.338090707,0.645480495,4846,-0.307389788
22041,2506,6514,9162,0.273521065,0.710980135,4008,-0.43745907,LA,Franklin Parish,,9336,2921,6294,0.312874893,0.674164524,3373,-0.361289632
22043,1181,7406,8819,0.13391541,0.839777753,6225,-0.705862343,LA,Grant Parish,,8666,1421,7082,0.163974152,0.817216709,5661,-0.653242557
22045,10698,20903,32454,0.329635792,0.644080853,10205,-0.314445061,LA,Iberia Parish,,33392,12129,20890,0.363230714,0.625598946,8761,-0.262368232
22047,8324,7320,16043,0.518855576,0.456273764,1004,0.062581811,LA,Iberville Parish,,17014,9548,7271,0.561184907,0.427353944,2277,0.133830963
22049,2139,5169,7464,0.286575563,0.692524116,3030,-0.405948553,LA,Jackson Parish,,7529,2305,5132,0.306149555,0.681631027,2827,-0.375481472
22051,73540,100292,181388,0.405429246,0.552914195,26752,-0.147484949,LA,Jefferson Parish,,175733,70000,102325,0.39833156,0.582275384,32325,-0.183943824
22053,3080,10775,14277,0.215731596,0.754710373,7695,-0.538978777,LA,Jefferson Davis Parish,,13733,3483,10014,0.253622661,0.729192456,6531,-0.475569795
22055,32726,68191,105599,0.309908238,0.645754221,35465,-0.335845983,LA,Lafayette Parish,,98637,31766,64989,0.322049535,0.658870404,33223,-0.336820868
22057,8423,31958,41644,0.202262031,0.767409471,23535,-0.56514744,LA,Lafourche Parish,,38725,9543,28332,0.246429955,0.7316204,18789,-0.485190445
22059,605,5835,6568,0.092113276,0.888398295,5230,-0.796285018,LA,La Salle Parish,,6572,764,5726,0.116250761,0.871272063,4962,-0.755021302
22061,7102,10761,18664,0.380518646,0.576564509,3659,-0.196045864,LA,Lincoln Parish,,18974,7947,10731,0.418836302,0.565563403,2784,-0.1467271
22063,6950,48797,57700,0.120450607,0.845701906,41847,-0.7252513,LA,Livingston Parish,,54033,7448,45488,0.137841689,0.841855903,38040,-0.704014214
22065,2744,1927,4732,0.579881657,0.407227388,817,0.172654269,LA,Madison Parish,,5187,3154,2000,0.608058608,0.385579333,1154,0.222479275
22067,5155,6502,11852,0.434947688,0.548599393,1347,-0.113651704,LA,Morehouse Parish,,12613,5887,6591,0.466740664,0.522556093,704,-0.055815429
22069,7143,8965,16617,0.429860986,0.539507733,1822,-0.109646747,LA,Natchitoches Parish,,17257,7941,9077,0.460161094,0.525989454,1136,-0.06582836
22071,133833,24267,165619,0.808077576,0.146523044,109566,0.661554532,LA,Orleans Parish,,157233,126199,27967,0.802624131,0.177869786,98232,0.624754345
22073,24420,41712,67987,0.359186315,0.613529057,17292,-0.254342742,LA,Ouachita Parish,,68437,26629,40927,0.389102386,0.59802446,14298,-0.208922074
22075,3347,6900,10572,0.316590995,0.652667423,3553,-0.336076428,LA,Plaquemines Parish,,10235,3597,6469,0.351441133,0.632046898,2872,-0.280605765
22077,4764,6789,11761,0.405067596,0.577246833,2025,-0.172179236,LA,Pointe Coupee Parish,,12147,5436,6548,0.447517906,0.539063143,1112,-0.091545238
22079,18318,36814,56838,0.322284387,0.647700482,18496,-0.325416095,LA,Rapides Parish,,58008,20040,37187,0.34546959,0.641066749,17147,-0.295597159
22081,1938,2391,4422,0.438263229,0.540705563,453,-0.102442334,LA,Red River Parish,,4807,2253,2483,0.468691492,0.516538382,230,-0.04784689
22083,3157,6286,9596,0.328991246,0.65506461,3129,-0.326073364,LA,Richland Parish,,11507,4074,7316,0.354045364,0.635786912,3242,-0.281741549
22085,1703,7877,9785,0.174041901,0.805007665,6174,-0.630965764,LA,Sabine Parish,,10050,2194,7735,0.218308458,0.769651741,5541,-0.551343284
22087,4957,10232,15807,0.313595243,0.647308155,5275,-0.333712912,LA,St. Bernard Parish,,13944,5052,8497,0.362306368,0.609366036,3445,-0.247059667
22089,8558,16620,26190,0.326765941,0.634593356,8062,-0.307827415,LA,St. Charles Parish,,25330,8894,15936,0.351125148,0.629135413,7042,-0.278010265
22091,3353,2497,5964,0.562206573,0.418678739,856,0.143527834,LA,St. Helena Parish,,7093,4233,2756,0.596785563,0.388552094,1477,0.20823347
22093,6418,5456,12085,0.531071576,0.451468763,962,0.079602813,LA,St. James Parish,,12391,7055,5209,0.569364862,0.420385764,1846,0.148979098
22095,12658,7569,20740,0.610318226,0.364946962,5089,0.245371263,LA,St. John the Baptist Parish,,21122,13178,7620,0.623899252,0.360761292,5558,0.26313796
22097,17208,21966,39970,0.430522892,0.549562172,4758,-0.119039279,LA,St. Landry Parish,,41647,19668,21475,0.472254904,0.515643384,1807,-0.043388479
22099,8266,16872,25749,0.321022176,0.655248748,8606,-0.334226572,LA,St. Martin Parish,,25430,9419,15653,0.370389304,0.615532835,6234,-0.245143531
22101,8050,14353,22871,0.351974116,0.62756329,6303,-0.275589174,LA,St. Mary Parish,,23636,9448,13883,0.399729227,0.587366729,4435,-0.187637502
22103,27716,90914,124389,0.22281713,0.730884564,63198,-0.508067434,LA,St. Tammany Parish,,112884,25723,84710,0.227871089,0.750416357,58987,-0.522545268
22105,16869,33933,52381,0.322044253,0.647811229,17064,-0.325766977,LA,Tangipahoa Parish,,50090,17720,31583,0.353763226,0.630525055,13863,-0.276761829
22107,1329,1180,2543,0.522611089,0.464018875,149,0.058592214,LA,Tensas Parish,,2812,1564,1230,0.556187767,0.437411095,334,0.118776671
22109,10664,31900,43893,0.242954457,0.726767366,21236,-0.483812909,LA,Terrebonne Parish,,42335,12071,29500,0.285130507,0.69682296,17429,-0.411692453
22111,2691,7972,10894,0.247016706,0.731778961,5281,-0.484762254,LA,Union Parish,,10766,3075,7561,0.285621401,0.702303548,4486,-0.416682148
22113,4745,19807,25253,0.187898468,0.784342454,15062,-0.596443987,LA,Vermilion Parish,,24984,5718,18909,0.228866475,0.75684438,13191,-0.527977906
22115,2665,13471,16633,0.160223652,0.80989599,10806,-0.649672338,LA,Vernon Parish,,15606,3173,12146,0.203319236,0.778290401,8973,-0.574971165
22117,5690,12552,18622,0.305552572,0.674041456,6862,-0.368488884,LA,Washington Parish,,18100,6351,11470,0.350883978,0.633701657,5119,-0.28281768
22119,6259,11538,18140,0.345038589,0.636052922,5279,-0.291014333,LA,Webster Parish,,18413,6802,11397,0.369412915,0.618964862,4595,-0.249551947
22121,5382,6926,12710,0.423446105,0.544925256,1544,-0.12147915,LA,West Baton Rouge Parish,,12772,5692,6920,0.445662386,0.54181021,1228,-0.096147823
22123,715,3970,4759,0.150241647,0.834208867,3255,-0.68396722,LA,West Carroll Parish,,4548,853,3628,0.187554969,0.797713281,2775,-0.610158311
22125,2247,3390,5798,0.38754743,0.584684374,1143,-0.197136944,LA,West Feliciana Parish,,5777,2441,3257,0.422537649,0.563787433,816,-0.141249784
22127,1643,4605,6368,0.258008794,0.723146985,2962,-0.465138191,LA,Winn Parish,,6532,1919,4539,0.293784446,0.694886712,2620,-0.401102266
23001,22975,28189,55340,0.415160824,0.509378388,5214,-0.094217564,ME,Androscoggin County,,52539,28912,22210,0.550295971,0.422733588,6702,0.127562382
23003,13377,19419,34963,0.382604468,0.555415725,6042,-0.172811258,ME,Aroostook County,,33866,17844,15229,0.526900136,0.449684049,2615,0.077216087
23005,102935,57697,171249,0.601083802,0.336918756,45238,0.264165046,ME,Cumberland County,,166895,100977,57008,0.605033105,0.341580035,43969,0.263453069
23007,7001,7900,16382,0.427359297,0.482236601,899,-0.054877304,ME,Franklin County,,16112,9292,6305,0.576713009,0.391323237,2987,0.185389772
23009,16107,13682,31983,0.503611293,0.427789763,2425,0.07582153,ME,Hancock County,,30738,17533,12398,0.570401457,0.403344395,5135,0.167057063
23011,29296,31753,65999,0.443885513,0.48111335,2457,-0.037227837,ME,Kennebec County,,63225,35022,26506,0.553926453,0.419232898,8516,0.134693555
23013,12440,9148,23021,0.540376178,0.397376309,3292,0.14299987,ME,Knox County,,22002,13227,8262,0.601172621,0.375511317,4965,0.225661304
23015,10241,9727,21432,0.477836879,0.45385405,514,0.023982829,ME,Lincoln County,,20668,11298,8884,0.546642152,0.429843236,2414,0.116798916
23017,12172,16214,31094,0.391458159,0.521451084,4042,-0.129992925,ME,Oxford County,,28734,16052,11766,0.558641331,0.409480058,4286,0.149161272
23019,32832,41601,80228,0.409233684,0.518534676,8769,-0.109300992,ME,Penobscot County,,77171,38816,36592,0.502986873,0.474167757,2224,0.028819116
23021,3098,5403,9144,0.3388014,0.590879265,2305,-0.252077865,ME,Piscataquis County,,8990,4168,4577,0.463626251,0.509121246,409,-0.045494994
23023,10679,9304,21596,0.49448972,0.430820522,1375,0.063669198,ME,Sagadahoc County,,20734,11821,8429,0.570126362,0.406530337,3392,0.163596026
23025,9092,14998,25968,0.350123229,0.577556993,5906,-0.227433765,ME,Somerset County,,24705,12211,11798,0.494272414,0.477555151,413,0.016717264
23027,10442,10378,22630,0.46142289,0.458594786,64,0.002828104,ME,Waldo County,,20976,11292,9055,0.538329519,0.431683829,2237,0.10664569
23029,6358,9037,16559,0.383960384,0.545745516,2679,-0.161785132,ME,Washington County,,15756,7797,7539,0.494859101,0.478484387,258,0.016374714
23031,55828,50388,113962,0.489882592,0.442147382,5440,0.04773521,ME,York County,,107627,61492,43879,0.571343622,0.407695095,17613,0.163648527
24001,6665,20025,27804,0.23971371,0.720220112,13360,-0.480506402,MD,Allegany County,,27817,9001,18158,0.323579106,0.652766294,9157,-0.329187188
24003,116074,114509,242939,0.477790721,0.471348775,1565,0.006441946,MD,Anne Arundel County,,239189,115960,118165,0.484804903,0.494023555,2205,-0.009218651
24005,189437,131009,335017,0.565454887,0.391051797,58428,0.17440309,MD,Baltimore County,,354655,202733,144686,0.571634405,0.407962668,58047,0.163671737
24009,16669,24680,43445,0.383680516,0.568074577,8011,-0.184394061,MD,Calvert County,,42168,18963,22413,0.449701195,0.53151679,3450,-0.081815595
24011,3747,8999,13282,0.282111128,0.677533504,5252,-0.395422376,MD,Caroline County,,12526,4621,7674,0.368912662,0.612645697,3053,-0.243733035
24013,24314,55593,84879,0.286454836,0.65496766,31279,-0.368512824,MD,Carroll County,,82171,26067,53960,0.317228706,0.656679364,27893,-0.339450658
24015,12651,27579,42309,0.299014394,0.651847125,14928,-0.352832731,MD,Cecil County,,40037,15489,23660,0.386867148,0.590953368,8171,-0.20408622
24017,46063,24163,72480,0.635527042,0.333374724,21900,0.302152318,MD,Charles County,,70167,45621,23637,0.650177434,0.336867758,21984,0.313309675
24019,5695,7938,14034,0.4058002,0.565626336,2243,-0.159826137,MD,Dorchester County,,14249,6570,7514,0.461084988,0.527335252,944,-0.066250263
24021,51891,56472,114962,0.451375237,0.491223187,4581,-0.03984795,MD,Frederick County,,109127,51187,55495,0.469058986,0.508535926,4308,-0.03947694
24023,2252,10189,12905,0.174506005,0.789538938,7937,-0.615032933,MD,Garrett County,,12113,2792,9102,0.230496161,0.75142409,6310,-0.520927929
24025,43803,74261,124224,0.352613022,0.597799137,30458,-0.245186115,MD,Harford County,,118417,46390,69496,0.391751184,0.586875195,23106,-0.195124011
24027,93808,44792,146401,0.640760651,0.305954194,49016,0.334806456,MD,Howard County,,141167,84017,54094,0.595160342,0.383191539,29923,0.211968803
24029,4178,4598,9166,0.455814968,0.501636483,420,-0.045821514,MD,Kent County,,9143,4453,4533,0.487039265,0.495789128,80,-0.008749863
24031,309761,82985,408300,0.758660299,0.203245163,226776,0.555415136,MD,Montgomery County,,404214,286493,110940,0.708765654,0.274458579,175553,0.434307075
24033,313627,29290,351091,0.893292622,0.083425665,284337,0.809866958,MD,Prince George's County,,352292,317342,32236,0.900792524,0.091503639,285106,0.809288885
24035,7316,16211,24633,0.296999959,0.658100922,8895,-0.361100962,MD,Queen Anne's County,,23153,7898,14879,0.341122101,0.642638103,6981,-0.301516002
24037,15786,26889,45169,0.34948748,0.59529766,11103,-0.24581018,MD,St. Mary's County,,44076,17982,25096,0.40797713,0.569380162,7114,-0.161403031
24039,3484,5056,8768,0.397354015,0.576642336,1572,-0.179288321,MD,Somerset County,,9272,4478,4706,0.482959448,0.507549612,228,-0.024590164
24041,7865,10098,18731,0.419892157,0.539106294,2233,-0.119214137,MD,Talbot County,,18671,7983,10442,0.427561459,0.559263028,2459,-0.131701569
24043,19193,38842,60731,0.316032998,0.639574517,19649,-0.323541519,MD,Washington County,,58653,23282,34113,0.396944743,0.581607079,10831,-0.184662336
24045,16327,20832,38722,0.421646609,0.53798874,4505,-0.116342131,MD,Wicomico County,,38256,17481,20136,0.45694793,0.526348808,2655,-0.069400878
24047,8783,15910,25571,0.34347503,0.622189199,7127,-0.278714168,MD,Worcester County,,24526,9841,14334,0.401247656,0.584441001,4493,-0.183193346
24510,178562,22726,208980,0.854445401,0.108747249,155836,0.745698153,MD,Baltimore city,,229897,201042,25501,0.87448727,0.110923588,175541,0.763563683
25001,71632,53842,132667,0.539938342,0.405843201,17790,0.13409514,MA,Barnstable County,,132212,70329,60221,0.531941125,0.455488155,10108,0.076452969
25003,43540,16799,64507,0.674965508,0.26042135,26741,0.414544158,MA,Berkshire County,,64078,48596,14209,0.758388214,0.221745373,34387,0.536642842
25005,127619,104775,246068,0.518633061,0.425796934,22844,0.092836127,MA,Bristol County,,239565,142481,93448,0.594748816,0.390073675,49033,0.20467514
25007,8338,2474,11434,0.729228616,0.216372223,5864,0.512856393,MA,Dukes County,,10914,7955,2789,0.728880337,0.255543339,5166,0.473336998
25009,220027,135405,376140,0.584960387,0.359985644,84622,0.224974743,MA,Essex County,,363246,208723,149808,0.574605089,0.412414727,58915,0.162190361
25011,24369,10327,37987,0.641508937,0.271856161,14042,0.369652776,MA,Franklin County,,37600,27024,9338,0.718723404,0.248351064,17686,0.47037234
25013,110313,78230,200220,0.550958945,0.390720208,32083,0.160238737,MA,Hampden County,,197827,122571,72318,0.619586811,0.365561829,50253,0.254024981
25015,54572,22089,82329,0.662852701,0.268301571,32483,0.39455113,MA,Hampshire County,,80406,56552,21366,0.703330597,0.265726438,35186,0.437604159
25017,508919,216163,767337,0.6632275,0.281705431,292756,0.381522069,MA,Middlesex County,,746856,467173,266307,0.625519511,0.356570745,200866,0.268948767
25019,4144,1892,6404,0.647095565,0.29544035,2252,0.351655215,MA,Nantucket County,,6097,3828,2185,0.627849762,0.35837297,1643,0.269476792
25021,219129,119171,357781,0.612466844,0.333083646,99958,0.279383198,MA,Norfolk County,,350195,200891,144654,0.573654678,0.413067006,56237,0.160587673
25023,133828,114722,264168,0.506601859,0.434276672,19106,0.072325187,MA,Plymouth County,,253993,130278,120708,0.512919647,0.475241444,9570,0.037678204
25025,241212,50042,303517,0.794723195,0.164873796,191170,0.629849399,MA,Suffolk County,,282649,219208,58872,0.775548472,0.208286603,160336,0.567261869
25027,197126,157138,380972,0.517429102,0.412466008,39988,0.104963094,MA,Worcester County,,364093,195667,162022,0.537409398,0.445001689,33645,0.092407709
26001,1732,4201,6179,0.280304256,0.679883476,2469,-0.39957922,MI,Alcona County,,6086,2462,3571,0.404534998,0.58675649,1109,-0.182221492
26003,1663,2585,4513,0.368491026,0.572789719,922,-0.204298693,MI,Alger County,,4603,2212,2329,0.480556159,0.505974365,117,-0.025418206
26005,17932,33812,55153,0.325131906,0.61305822,15880,-0.287926314,MI,Allegan County,,49199,19594,29023,0.398260127,0.589910364,9429,-0.191650237
26007,4877,9090,14688,0.33203976,0.618872549,4213,-0.286832789,MI,Alpena County,,14014,6549,7298,0.467318396,0.520764949,749,-0.053446553
26009,4448,8469,13572,0.327733569,0.624005305,4021,-0.296271736,MI,Antrim County,,13184,5107,7917,0.387363471,0.600500607,2810,-0.213137136
26011,2238,4704,7457,0.300120692,0.630816682,2466,-0.33069599,MI,Arenac County,,7826,3669,4054,0.468821876,0.518016867,385,-0.049194991
26013,1156,2158,3486,0.331612163,0.619047619,1002,-0.287435456,MI,Baraga County,,3490,1574,1866,0.451002865,0.534670487,292,-0.083667622
26015,9109,19197,30265,0.300974723,0.634297043,10088,-0.33332232,MI,Barry County,,28483,11496,16651,0.40360917,0.584594319,5155,-0.180985149
26017,21641,28327,52932,0.408845311,0.535158316,6686,-0.126313005,MI,Bay County,,51077,26797,23735,0.52463927,0.464690565,3062,0.059948705
26019,4108,5539,10221,0.401917621,0.541923491,1431,-0.14000587,MI,Benzie County,,9847,4683,5071,0.475576318,0.514979181,388,-0.039402864
26021,29496,38646,71882,0.410339167,0.537631118,9150,-0.127291951,MI,Berrien County,,72322,33465,38209,0.46272227,0.528317801,4744,-0.065595531
26023,4740,11025,16490,0.287446938,0.668587022,6285,-0.381140085,MI,Branch County,,16278,6526,9575,0.400909203,0.588217226,3049,-0.187308023
26025,24154,31489,58786,0.410880142,0.535654748,7335,-0.124774606,MI,Calhoun County,,58231,29270,28338,0.502653226,0.486648005,932,0.016005221
26027,7270,14241,23272,0.312392575,0.611937092,6971,-0.299544517,MI,Cass County,,22461,9587,12660,0.426828725,0.563643649,3073,-0.136814924
26029,5137,8674,14567,0.352646393,0.595455482,3537,-0.242809089,MI,Charlevoix County,,14064,5936,7997,0.422070535,0.568614903,2061,-0.146544369
26031,4302,8680,13647,0.315234117,0.636037224,4378,-0.320803107,MI,Cheboygan County,,13288,5829,7284,0.438666466,0.548163757,1455,-0.109497291
26033,5378,9120,15434,0.348451471,0.590903201,3742,-0.24245173,MI,Chippewa County,,15564,7100,8278,0.45618093,0.531868414,1178,-0.075687484
26035,4250,8507,13385,0.317519612,0.635562196,4257,-0.318042585,MI,Clare County,,13492,6337,6988,0.46968574,0.517936555,651,-0.048250815
26037,16490,21635,40564,0.406518095,0.533354699,5145,-0.126836604,MI,Clinton County,,39125,18187,20630,0.46484345,0.527284345,2443,-0.062440895
26039,2110,4354,6833,0.308795551,0.637201815,2244,-0.328406264,MI,Crawford County,,6814,2994,3744,0.439389492,0.549457,750,-0.110067508
26041,6431,11112,18467,0.348242812,0.601721991,4681,-0.253479179,MI,Delta County,,18043,8330,9533,0.461674888,0.528348944,1203,-0.066674056
26043,3923,8580,13140,0.298554033,0.652968037,4657,-0.354414003,MI,Dickinson County,,12785,4952,7688,0.387328901,0.601329683,2736,-0.214000782
26045,24534,27608,55686,0.440577524,0.495779909,3074,-0.055202385,MI,Eaton County,,54707,27912,26193,0.510208931,0.478786993,1719,0.031421939
26047,6972,10616,18774,0.371364653,0.565462874,3644,-0.194098221,MI,Emmet County,,17672,7225,10253,0.408838841,0.580183341,3028,-0.1713445
26049,102744,84174,196135,0.523843271,0.429163586,18570,0.094679685,MI,Genesee County,,202699,128972,71807,0.636273489,0.354254338,57165,0.282019152
26051,3794,8124,12472,0.304201411,0.651379089,4330,-0.347177678,MI,Gladwin County,,12552,5760,6661,0.458891013,0.530672403,901,-0.071781389
26053,2925,4019,7313,0.399972651,0.54956926,1094,-0.149596609,MI,Gogebic County,,7576,4058,3444,0.53563886,0.454593453,614,0.081045407
26055,20964,27412,51460,0.407384376,0.532685581,6448,-0.125301205,MI,Grand Traverse County,,47901,20875,26532,0.43579466,0.553892403,5657,-0.118097743
26057,5665,9878,16442,0.344544459,0.600778494,4213,-0.256234035,MI,Gratiot County,,16011,7606,8236,0.475048404,0.514396353,630,-0.039347948
26059,4799,14094,19880,0.24139839,0.708953722,9295,-0.467555332,MI,Hillsdale County,,19081,7106,11727,0.372412347,0.61459043,4621,-0.242178083
26061,6018,8475,15623,0.385201306,0.542469436,2457,-0.15726813,MI,Houghton County,,14804,6530,8040,0.441097001,0.54309646,1510,-0.10199946
26063,4579,10629,15848,0.288932357,0.670683998,6050,-0.381751641,MI,Huron County,,15274,6432,8686,0.421107765,0.568678801,2254,-0.147571036
26065,81266,44354,133478,0.608834415,0.332294461,36912,0.276539954,MI,Ingham County,,127579,80903,45365,0.634140415,0.355583599,35538,0.278556816
26067,8206,16374,26364,0.311257776,0.621074192,8168,-0.309816416,MI,Ionia County,,25730,11016,14319,0.42813836,0.556509911,3303,-0.128371551
26069,4344,8344,13349,0.325417634,0.625065548,4000,-0.299647914,MI,Iosco County,,13330,6242,6906,0.468267067,0.51807952,664,-0.049812453
26071,2004,3675,5910,0.339086294,0.621827411,1671,-0.282741117,MI,Iron County,,5987,2687,3224,0.448805746,0.538500084,537,-0.089694338
26073,11404,12338,25344,0.449968434,0.486821338,934,-0.036852904,MI,Isabella County,,24119,13038,10800,0.540569675,0.447779759,2238,0.092789917
26075,25795,39793,69567,0.370793623,0.572009717,13998,-0.201216094,MI,Jackson County,,69323,32301,36298,0.465949252,0.523606884,3997,-0.057657632
26077,67142,51031,125966,0.533016846,0.405117254,16111,0.127899592,MI,Kalamazoo County,,122880,69045,52660,0.561889648,0.428548177,16385,0.133341471
26079,2279,6213,8920,0.255493274,0.696524664,3934,-0.44103139,MI,Kalkaska County,,8281,3268,4897,0.394638329,0.591353701,1629,-0.196715373
26081,138567,147959,306270,0.452434127,0.483099879,9392,-0.030665752,MI,Kent County,,295418,134560,157801,0.455490187,0.534161764,23241,-0.078671577
26083,527,814,1429,0.368789363,0.569629111,287,-0.200839748,MI,Keweenaw County,,1388,582,774,0.419308357,0.557636888,192,-0.13832853
26085,1939,3159,5328,0.363926426,0.592905405,1220,-0.228978979,MI,Lake County,,5287,2752,2487,0.520522035,0.470399092,265,0.050122943
26087,12734,30037,45126,0.282187652,0.665625139,17303,-0.383437486,MI,Lapeer County,,43025,18786,23725,0.436629866,0.551423591,4939,-0.114793725
26089,6774,7239,14757,0.45903639,0.490546859,465,-0.03151047,MI,Leelanau County,,14164,6576,7483,0.464275628,0.528311212,907,-0.064035583
26091,16750,26428,45895,0.364963504,0.575836148,9678,-0.210872644,MI,Lenawee County,,44619,21774,22351,0.487998386,0.500930097,577,-0.012931711
26093,34378,65665,105577,0.325620163,0.621963117,31287,-0.296342953,MI,Livingston County,,97959,37186,60000,0.379607795,0.612501148,22814,-0.232893353
26095,681,1756,2576,0.264363354,0.681677019,1075,-0.417313665,MI,Luce County,,2477,951,1501,0.383932176,0.60597497,550,-0.222042794
26097,2085,3740,6088,0.342477004,0.614323259,1655,-0.271846255,MI,Mackinac County,,6097,2652,3396,0.434968017,0.556995244,744,-0.122027227
26099,176238,224589,418773,0.420843751,0.536302484,48351,-0.115458733,MI,Macomb County,,403388,207992,191896,0.51561276,0.47571073,16096,0.03990203
26101,4979,6915,12598,0.395221464,0.54889665,1936,-0.153675187,MI,Manistee County,,12385,6467,5736,0.522163908,0.463140896,731,0.059023012
26103,16042,14646,32897,0.48764325,0.44520777,1396,0.04243548,MI,Marquette County,,32144,18126,13609,0.56389995,0.423376058,4517,0.140523892
26105,5281,8505,14658,0.360281075,0.580229226,3224,-0.219948151,MI,Mason County,,14588,6856,7580,0.469975322,0.519605155,724,-0.049629833
26107,5827,10305,17149,0.339786576,0.600909674,4478,-0.261123098,MI,Mecosta County,,16879,7515,9175,0.445227798,0.543574856,1660,-0.098347058
26109,3539,6704,10765,0.328750581,0.622758941,3165,-0.29400836,MI,Menominee County,,10922,5244,5565,0.480131844,0.509522066,321,-0.029390222
26111,15655,23877,42379,0.369404658,0.563415843,8222,-0.194011185,MI,Midland County,,41808,17480,23942,0.418101799,0.572665519,6462,-0.15456372
26113,1565,5386,7301,0.214354198,0.737707163,3821,-0.523352965,MI,Missaukee County,,7024,2274,4665,0.323747153,0.664151481,2391,-0.340404328
26115,26859,43255,74101,0.362464744,0.583730314,16396,-0.22126557,MI,Monroe County,,72682,36310,35593,0.499573484,0.489708594,717,0.009864891
26117,7874,16907,26556,0.296505498,0.636654617,9033,-0.340149119,MI,Montcalm County,,25383,11431,13624,0.450340779,0.536737186,2193,-0.086396407
26119,1286,3498,5008,0.256789137,0.698482428,2212,-0.441693291,MI,Montmorency County,,5051,2049,2928,0.405662245,0.579687191,879,-0.174024946
26121,36640,35962,77114,0.475140701,0.466348523,678,0.008792178,MI,Muskegon County,,76054,44436,30882,0.584269072,0.406053593,13554,0.178215478
26123,6212,15174,22605,0.274806459,0.671267419,8962,-0.39646096,MI,Newaygo County,,21424,8723,12458,0.407160194,0.581497386,3735,-0.174337192
26125,342976,289127,663255,0.517110312,0.435921327,53849,0.081188985,MI,Oakland County,,650306,349055,296531,0.536755005,0.455986874,52524,0.080768131
26127,3973,7228,11903,0.3337814,0.607241872,3255,-0.273460472,MI,Oceana County,,11438,5063,6239,0.442647316,0.545462493,1176,-0.102815177
26129,3030,6827,10386,0.291738879,0.657327171,3797,-0.365588292,MI,Ogemaw County,,10361,4791,5437,0.462407104,0.524756298,646,-0.062349194
26131,1175,2069,3420,0.343567251,0.60497076,894,-0.261403509,MI,Ontonagon County,,3535,1585,1906,0.448373409,0.539179632,321,-0.090806223
26133,2705,7336,10597,0.255260923,0.692271398,4631,-0.437010475,MI,Osceola County,,10265,3981,6140,0.387822698,0.59814905,2159,-0.210326352
26135,1044,2843,4062,0.257016248,0.699901526,1799,-0.442885278,MI,Oscoda County,,4027,1654,2308,0.410727589,0.573131363,654,-0.162403775
26137,3556,8266,12529,0.283821534,0.659749381,4710,-0.375927847,MI,Otsego County,,11829,4681,7008,0.395722377,0.592442303,2327,-0.196719926
26139,46276,90456,145405,0.318255906,0.622096902,44180,-0.303840996,MI,Ottawa County,,132695,43068,88503,0.324563849,0.666965598,45435,-0.342401748
26141,2400,4486,7215,0.332640333,0.621760222,2086,-0.289119889,MI,Presque Isle County,,7077,3192,3794,0.451038576,0.536102868,602,-0.085064293
26143,4287,8141,13036,0.328858546,0.624501381,3854,-0.295642835,MI,Roscommon County,,13032,6198,6701,0.475598527,0.514195826,503,-0.038597299
26145,44395,45469,94198,0.471294507,0.482696023,1074,-0.011401516,MI,Saginaw County,,97903,54372,42716,0.555366026,0.436309408,11656,0.119056617
26147,24553,49067,77994,0.314806267,0.629112496,24514,-0.314306229,MI,St. Clair County,,73740,33845,39076,0.458977488,0.529915921,5231,-0.070938432
26149,7529,14886,23765,0.316810436,0.626383337,7357,-0.309572901,MI,St. Joseph County,,23314,10106,12975,0.433473449,0.556532556,2869,-0.123059106
26151,4873,13446,19243,0.253234943,0.698747597,8573,-0.445512654,MI,Sanilac County,,18359,7212,10961,0.392831854,0.597036876,3749,-0.204205022
26153,1369,2556,4151,0.329800048,0.61575524,1187,-0.285955192,MI,Schoolcraft County,,4046,1865,2142,0.460949086,0.529411765,277,-0.068462679
26155,12547,19232,34044,0.368552462,0.564915991,6685,-0.19636353,MI,Shiawassee County,,33590,17197,15962,0.511967848,0.475200953,1235,0.036766895
26157,7493,17421,26157,0.286462515,0.666016745,9928,-0.37955423,MI,Tuscola County,,26482,11643,14517,0.439657126,0.548183672,2874,-0.108526546
26159,13258,17890,33213,0.399181044,0.538644507,4632,-0.139463463,MI,Van Buren County,,32798,16288,16140,0.496615647,0.492103177,148,0.00451247
26161,128025,50335,187201,0.683890578,0.268882111,77690,0.415008467,MI,Washtenaw County,,179016,120791,56401,0.674749743,0.315061224,64390,0.359688519
26163,517842,228908,775450,0.667795474,0.295193758,288934,0.372601715,MI,Wayne County,,814108,595253,213586,0.731172031,0.262355855,381667,0.468816177
26165,4436,10000,15279,0.290333137,0.654493095,5564,-0.364159958,MI,Wexford County,,13859,5717,7972,0.412511725,0.575221877,2255,-0.162710152
27001,3134,5516,9185,0.341208492,0.600544366,2382,-0.259335874,MN,Aitkin County,,9109,4412,4533,0.484356131,0.497639697,121,-0.013283566
27003,75499,93341,184084,0.410133417,0.507056561,17842,-0.096923144,MN,Anoka County,,185714,88611,93430,0.477136888,0.503085389,4819,-0.025948501
27005,5208,10880,17090,0.304739614,0.636629608,5672,-0.331889994,MN,Becker County,,16329,6829,9204,0.418212995,0.563659746,2375,-0.145446751
27007,8688,10783,21316,0.40758116,0.50586414,2095,-0.09828298,MN,Beltrami County,,21949,11818,9637,0.538429997,0.439063283,2181,0.099366714
27009,5640,12872,19911,0.283260509,0.646476822,7232,-0.363216313,MN,Benton County,,19521,8173,10849,0.418677322,0.555760463,2676,-0.137083141
27011,921,1607,2729,0.337486259,0.588860388,686,-0.25137413,MN,Big Stone County,,2783,1345,1385,0.483291412,0.497664391,40,-0.014372979
27013,14428,15667,33256,0.433846524,0.471102959,1239,-0.037256435,MN,Blue Earth County,,34039,18164,14916,0.533623197,0.438203237,3248,0.095419959
27015,3763,8708,13663,0.275415355,0.637341726,4945,-0.36192637,MN,Brown County,,13882,5630,7938,0.405561158,0.571819623,2308,-0.166258464
27017,8460,8160,18059,0.468464478,0.451852262,300,0.016612216,MN,Carlton County,,18356,11389,6586,0.620451079,0.358792765,4803,0.261658313
27019,21508,29057,55102,0.39033066,0.527331131,7549,-0.137000472,MN,Carver County,,52747,20745,31155,0.39329251,0.590649705,10410,-0.197357196
27021,4949,9982,15885,0.311551778,0.628391564,5033,-0.316839786,MN,Cass County,,16080,6858,8957,0.426492537,0.557027363,2099,-0.130534826
27023,1978,3764,6182,0.319961178,0.608864445,1786,-0.288903268,MN,Chippewa County,,6176,3083,2967,0.499190415,0.480408031,116,0.018782383
27025,9279,18441,30009,0.309207238,0.614515645,9162,-0.305308407,MN,Chisago County,,29331,12524,16227,0.42698851,0.553237189,3703,-0.126248679
27027,12974,13549,29108,0.44571939,0.465473409,575,-0.01975402,MN,Clay County,,28771,15210,12920,0.528657329,0.449063293,2290,0.079594036
27029,1100,2925,4225,0.26035503,0.692307692,1825,-0.431952663,MN,Clearwater County,,4183,1753,2359,0.419077217,0.563949319,606,-0.144872101
27031,1912,1156,3360,0.569047619,0.344047619,756,0.225,MN,Cook County,,3304,1993,1221,0.603208232,0.369552058,772,0.233656174
27033,1678,3679,5697,0.294540986,0.64577848,2001,-0.351237493,MN,Cottonwood County,,5848,2433,3316,0.416039672,0.567031464,883,-0.150991792
27035,10982,22287,35568,0.308760684,0.626602564,11305,-0.31784188,MN,Crow Wing County,,34800,14760,19415,0.424137931,0.557902299,4655,-0.133764368
27037,110251,99624,228659,0.482163396,0.435688077,10627,0.046475319,MN,Dakota County,,230023,116252,109514,0.505392939,0.476100216,6738,0.029292723
27039,3102,6527,10564,0.293638773,0.617853086,3425,-0.324214313,MN,Dodge County,,10272,4487,5522,0.436818536,0.537577882,1035,-0.100759346
27041,6227,13966,21623,0.287980391,0.645886325,7739,-0.357905933,MN,Douglas County,,20917,8665,11905,0.414256347,0.569154276,3240,-0.15489793
27043,2153,4659,7355,0.292726037,0.633446635,2506,-0.340720598,MN,Faribault County,,7689,3407,4104,0.443100533,0.533749512,697,-0.090648979
27045,3872,6271,10976,0.352769679,0.571337464,2399,-0.218567784,MN,Fillmore County,,10854,5713,4913,0.526349733,0.452644186,800,0.073705546
27047,6041,8808,15929,0.379245401,0.552953732,2767,-0.173708331,MN,Freeborn County,,16645,9327,6970,0.560348453,0.418744368,2357,0.141604085
27049,9446,14041,25538,0.369880179,0.549808129,4595,-0.179927951,MN,Goodhue County,,25701,12212,12986,0.475156609,0.505272168,774,-0.03011556
27051,1104,2063,3453,0.319721981,0.597451491,959,-0.277729511,MN,Grant County,,3471,1647,1748,0.474503025,0.503601268,101,-0.029098243
27053,429283,191768,672644,0.638202377,0.285095831,237515,0.353106547,MN,Hennepin County,,677965,423979,240073,0.625370041,0.35410825,183906,0.271261791
27055,4145,5616,10515,0.394198764,0.534094151,1471,-0.139895388,MN,Houston County,,10422,5281,4951,0.506716561,0.475052773,330,0.031663788
27057,3432,7269,11423,0.300446468,0.63634772,3837,-0.335901252,MN,Hubbard County,,11482,4676,6622,0.407246124,0.576728793,1946,-0.169482669
27059,5656,13635,20875,0.270946108,0.653173653,7979,-0.382227545,MN,Isanti County,,20131,8024,11675,0.39858924,0.579951319,3651,-0.181362078
27061,9015,12920,23650,0.381183932,0.546300211,3905,-0.165116279,MN,Itasca County,,23833,12852,10500,0.539252297,0.440565602,2352,0.098686695
27063,1492,3609,5453,0.273610856,0.661837521,2117,-0.388226664,MN,Jackson County,,5415,2268,3044,0.418836565,0.562142198,776,-0.143305633
27065,2327,5230,8125,0.2864,0.643692308,2903,-0.357292308,MN,Kanabec County,,8107,3586,4319,0.442333786,0.532749476,733,-0.09041569
27067,7266,12785,21648,0.335643016,0.590585735,5519,-0.25494272,MN,Kandiyohi County,,21403,9806,11239,0.458160071,0.525113302,1433,-0.066953231
27069,823,1349,2363,0.348286077,0.570884469,526,-0.222598392,MN,Kittson County,,2405,1241,1095,0.516008316,0.455301455,146,0.060706861
27071,2306,3569,6313,0.365277998,0.565341359,1263,-0.200063361,MN,Koochiching County,,6432,3451,2841,0.53653607,0.441697761,610,0.094838308
27073,1301,2294,3835,0.339243807,0.598174707,993,-0.2589309,MN,Lac qui Parle County,,3974,1974,1938,0.496728737,0.487669854,36,0.009058883
27075,3077,2932,6472,0.475432633,0.45302843,145,0.022404203,MN,Lake County,,6797,4043,2610,0.594821245,0.383992938,1433,0.210828307
27077,553,1540,2230,0.247982063,0.69058296,987,-0.442600897,MN,Lake of the Woods County,,2220,859,1306,0.386936937,0.588288288,447,-0.201351351
27079,4623,9182,14867,0.310957153,0.617609471,4559,-0.306652317,MN,Le Sueur County,,14730,6753,7714,0.458452138,0.523693143,961,-0.065241005
27081,860,1930,3002,0.286475683,0.64290473,1070,-0.356429047,MN,Lincoln County,,3113,1428,1594,0.458721491,0.512046258,166,-0.053324767
27083,3825,7256,12129,0.315359881,0.598235634,3431,-0.282875752,MN,Lyon County,,12334,5465,6595,0.443084158,0.534700827,1130,-0.091616669
27085,4978,12155,18684,0.266431171,0.650556626,7177,-0.384125455,MN,McLeod County,,18455,6970,11069,0.377675427,0.599783257,4099,-0.22210783
27087,930,991,2074,0.448408872,0.477820636,61,-0.029411765,MN,Mahnomen County,,2179,1276,871,0.58558972,0.399724644,405,0.185865076
27089,1225,3208,4794,0.255527743,0.669169796,1983,-0.413642053,MN,Marshall County,,4335,1854,2380,0.427681661,0.549019608,526,-0.121337947
27091,2733,7062,10469,0.261056452,0.674562996,4329,-0.413506543,MN,Martin County,,10927,4054,6657,0.371007596,0.609224856,2603,-0.23821726
27093,3192,8103,12198,0.261682243,0.664289228,4911,-0.402606985,MN,Meeker County,,12167,4969,6913,0.40839977,0.568176214,1944,-0.159776444
27095,3709,8340,12948,0.286453506,0.644114921,4631,-0.357661415,MN,Mille Lacs County,,13047,5829,6951,0.446769372,0.532766153,1122,-0.085996781
27097,3637,12925,17534,0.207425573,0.737139272,9288,-0.529713699,MN,Morrison County,,16662,6153,10159,0.369283399,0.609710719,4006,-0.24042732
27099,7444,8826,17587,0.423267186,0.501847956,1382,-0.07858077,MN,Mower County,,18471,11129,6938,0.602512046,0.37561583,4191,0.226896216
27101,1295,2974,4642,0.27897458,0.640672124,1679,-0.361697544,MN,Murray County,,4754,2160,2504,0.454354228,0.526714346,344,-0.072360118
27103,7886,8436,17914,0.440214357,0.470916602,550,-0.030702244,MN,Nicollet County,,18285,9652,8214,0.52786437,0.449220673,1438,0.078643697
27105,2733,5299,8592,0.318086592,0.616736499,2566,-0.298649907,MN,Nobles County,,8493,3793,4581,0.446603085,0.539385376,788,-0.092782291
27107,1264,1699,3232,0.391089109,0.525680693,435,-0.134591584,MN,Norman County,,3199,1730,1384,0.540793998,0.432635198,346,0.1081588
27109,36266,35668,79277,0.457459288,0.449916117,598,0.007543171,MN,Olmsted County,,77951,39338,36832,0.504650357,0.472501956,2506,0.032148401
27111,9339,20939,32284,0.289276422,0.648587536,11600,-0.359311114,MN,Otter Tail County,,31562,12165,18860,0.385431848,0.597554021,6695,-0.212122172
27113,2146,4000,6671,0.321690901,0.599610253,1854,-0.277919352,MN,Pennington County,,6493,3024,3304,0.465732327,0.508855691,280,-0.043123364
27115,4580,8191,13729,0.333600408,0.596620293,3611,-0.263019885,MN,Pine County,,13904,6750,6845,0.485471807,0.492304373,95,-0.006832566
27117,1127,3338,4779,0.235823394,0.698472484,2211,-0.46264909,MN,Pipestone County,,4637,1728,2828,0.372654734,0.609877076,1100,-0.237222342
27119,4712,8979,14698,0.320587835,0.610899442,4267,-0.290311607,MN,Polk County,,14644,6773,7615,0.462510243,0.520008194,842,-0.057497951
27121,2106,3793,6294,0.334604385,0.602637432,1687,-0.268033047,MN,Pope County,,6224,2981,3142,0.478952442,0.504820051,161,-0.025867609
27123,176929,70778,269161,0.657335201,0.262957858,106151,0.394377343,MN,Ramsey County,,277782,184936,86799,0.66575948,0.31247165,98137,0.35328783
27125,540,1141,1871,0.288615714,0.609834313,601,-0.3212186,MN,Red Lake County,,1963,928,978,0.472745797,0.498217015,50,-0.025471218
27127,1887,5137,7566,0.249405234,0.678958499,3250,-0.429553265,MN,Redwood County,,7761,3008,4570,0.38757892,0.588841644,1562,-0.201262724
27129,2117,4890,7563,0.279915377,0.646568822,2773,-0.366653444,MN,Renville County,,7684,3394,4149,0.441697033,0.539953149,755,-0.098256117
27131,14437,15429,32217,0.448117454,0.478908651,992,-0.030791197,MN,Rice County,,32160,17054,14380,0.53028607,0.447139303,2674,0.083146766
27133,1373,3091,4807,0.28562513,0.643020595,1718,-0.357395465,MN,Rock County,,4830,1945,2810,0.402691511,0.581780538,865,-0.179089027
27135,1856,5451,7767,0.238959701,0.701815373,3595,-0.462855671,MN,Roseau County,,7330,2772,4409,0.378171896,0.601500682,1637,-0.223328786
27137,57769,44631,111260,0.519225238,0.40114147,13138,0.118083768,MN,St. Louis County,,116460,74177,39675,0.636931135,0.34067491,34502,0.296256225
27139,28502,39948,74390,0.383142896,0.537007662,11446,-0.153864767,MN,Scott County,,71411,29714,40321,0.41609836,0.5646329,10607,-0.148534539
27141,13299,31049,47938,0.277420835,0.647690767,17750,-0.370269932,MN,Sherburne County,,46320,17597,27848,0.379900691,0.601208981,10251,-0.22130829
27143,1954,5193,7727,0.252879513,0.672059014,3239,-0.4191795,MN,Sibley County,,7785,2916,4693,0.374566474,0.602825947,1777,-0.228259473
27145,25575,47618,78985,0.323795657,0.602873963,22043,-0.279078306,MN,Stearns County,,78178,33552,43015,0.429174448,0.550218732,9463,-0.121044284
27147,6239,11198,19040,0.327678571,0.588130252,4959,-0.260451681,MN,Steele County,,19034,8706,9903,0.457392035,0.5202795,1197,-0.062887465
27149,2116,2800,5350,0.395514019,0.523364486,684,-0.127850467,MN,Stevens County,,5621,2742,2766,0.487813556,0.492083259,24,-0.004269703
27151,1679,2962,4968,0.337962963,0.596215781,1283,-0.258252818,MN,Swift County,,5087,2751,2248,0.54079025,0.441910753,503,0.098879497
27153,2783,8485,11944,0.233004019,0.710398526,5702,-0.477394508,MN,Todd County,,11762,4819,6719,0.409709233,0.571246387,1900,-0.161537154
27155,631,1050,1791,0.352317141,0.586264657,419,-0.233947515,MN,Traverse County,,1840,942,860,0.511956522,0.467391304,82,0.044565217
27157,3866,6989,11764,0.328629718,0.594100646,3123,-0.265470928,MN,Wabasha County,,11722,5415,6049,0.461951885,0.516038219,634,-0.054086333
27159,1684,4837,6894,0.24427038,0.701624601,3153,-0.457354221,MN,Wadena County,,6772,2492,4143,0.367985824,0.611783816,1651,-0.243797992
27161,2838,5967,9579,0.296273097,0.622925149,3129,-0.326652051,MN,Waseca County,,9706,4370,5116,0.450236967,0.527096641,746,-0.076859674
27163,67086,64429,142843,0.469648495,0.451047654,2657,0.018600841,MN,Washington County,,141711,70203,69137,0.495395559,0.487873207,1066,0.007522352
27165,1814,2768,4971,0.364916516,0.556829612,954,-0.191913096,MN,Watonwan County,,5115,2494,2517,0.487585533,0.492082111,23,-0.004496579
27167,893,2129,3279,0.272339128,0.649283318,1236,-0.37694419,MN,Wilkin County,,3212,1258,1884,0.391656289,0.586550436,626,-0.194894147
27169,11366,12122,25852,0.439656506,0.468899892,756,-0.029243385,MN,Winona County,,27103,14980,11480,0.552706342,0.423569347,3500,0.129136996
27171,20336,43274,69154,0.294068311,0.62576279,22938,-0.331694479,MN,Wright County,,69550,26584,41460,0.382228613,0.596117901,14876,-0.213889288
27173,1524,3382,5253,0.290119931,0.643822578,1858,-0.353702646,MN,Yellow Medicine County,,5397,2465,2806,0.456735223,0.519918473,341,-0.06318325
28001,6921,5125,12214,0.566644834,0.419600458,1796,0.147044375,MS,Adams County,,13621,7999,5542,0.587254974,0.406871742,2457,0.180383232
28003,2684,11817,14781,0.181584467,0.799472296,9133,-0.617887829,MS,Alcorn County,,14682,3449,11027,0.2349135,0.751055714,7578,-0.516142215
28005,2688,4282,7033,0.382198208,0.608844021,1594,-0.226645813,MS,Amite County,,7661,3218,4393,0.420049602,0.573423835,1175,-0.153374233
28007,2847,4288,7242,0.393123447,0.592101629,1441,-0.198978183,MS,Attala County,,7853,3368,4452,0.428880683,0.566917102,1084,-0.138036419
28009,1713,2240,3996,0.428678679,0.560560561,527,-0.131881882,MS,Benton County,,4080,2026,2030,0.496568627,0.49754902,4,-0.000980392
28011,8410,4251,12831,0.655443847,0.331306991,4159,0.324136856,MS,Bolivar County,,14258,9772,4346,0.685369617,0.304811334,5426,0.380558283
28013,1884,4360,6339,0.297207761,0.687805648,2476,-0.390597886,MS,Calhoun County,,6273,2250,3961,0.358680057,0.631436314,1711,-0.272756257
28015,1648,3774,5470,0.301279707,0.689945155,2126,-0.388665448,MS,Carroll County,,5968,1990,3953,0.33344504,0.662365952,1963,-0.328920912
28017,3649,4127,7890,0.462484157,0.523067174,478,-0.060583016,MS,Chickasaw County,,7641,3914,3601,0.512236618,0.471273394,313,0.040963225
28019,1198,2763,4020,0.29800995,0.687313433,1565,-0.389303483,MS,Choctaw County,,3847,1283,2533,0.333506629,0.658435144,1250,-0.324928516
28021,2523,414,2954,0.854096141,0.140148951,2109,0.71394719,MS,Claiborne County,,5258,4633,608,0.881133511,0.115633321,4025,0.76550019
28023,2556,5088,7713,0.331388565,0.6596655,2532,-0.328276935,MS,Clarke County,,7199,2695,4415,0.37435755,0.613279622,1720,-0.238922073
28025,5695,4136,9960,0.571787149,0.415261044,1559,0.156526104,MS,Clay County,,9659,5860,3735,0.606688063,0.386685992,2125,0.220002071
28027,6378,2426,8912,0.715664273,0.272217235,3952,0.443447038,MS,Coahoma County,,9563,7164,2356,0.7491373,0.246366203,4808,0.502771097
28029,6203,5576,11906,0.520997816,0.468335293,627,0.052662523,MS,Copiah County,,13002,7201,5714,0.553837871,0.439470851,1487,0.11436702
28031,3267,5423,8790,0.371672355,0.616951081,2156,-0.245278726,MS,Covington County,,9145,3800,5282,0.415527611,0.577583379,1482,-0.162055768
28033,19892,42155,64022,0.310705695,0.658445534,22263,-0.347739839,MS,DeSoto County,,64026,20979,42399,0.327663762,0.66221535,21420,-0.334551588
28035,11271,15149,27284,0.413099252,0.555233837,3878,-0.142134584,MS,Forrest County,,27789,12079,15339,0.434668394,0.551981,3260,-0.117312606
28037,1471,2685,4219,0.34866082,0.636406731,1214,-0.287745911,MS,Franklin County,,4443,1706,2705,0.383974792,0.608822867,999,-0.224848076
28039,1013,8652,9831,0.1030414,0.880073238,7639,-0.777031838,MS,George County,,9826,1352,8353,0.137594138,0.850091594,7001,-0.712497456
28041,956,4309,5325,0.179530516,0.809201878,3353,-0.629671362,MS,Greene County,,5919,1325,4528,0.223855381,0.764994087,3203,-0.541138706
28043,4386,5940,10442,0.420034476,0.568856541,1554,-0.148822065,MS,Grenada County,,11320,5279,5980,0.466342756,0.528268551,701,-0.061925795
28045,3320,13720,17517,0.189530171,0.783239139,10400,-0.593708968,MS,Hancock County,,17023,3879,12859,0.227868178,0.755389767,8980,-0.527521588
28047,20679,39710,62076,0.333123913,0.639699723,19031,-0.30657581,MS,Harrison County,,61602,22242,38646,0.361059706,0.627349761,16404,-0.266290056
28049,64922,24919,91536,0.709251005,0.27223169,40003,0.437019315,MS,Hinds County,,97639,70512,26450,0.722170444,0.270895851,44062,0.451274593
28051,5820,1151,7045,0.826117814,0.163378282,4669,0.662739532,MS,Holmes County,,8076,6775,1264,0.838905399,0.156513125,5511,0.682392273
28053,2652,924,3599,0.736871353,0.256737983,1728,0.48013337,MS,Humphreys County,,4481,3399,1069,0.758536041,0.238562821,2330,0.51997322
28055,395,298,699,0.56509299,0.426323319,97,0.138769671,MS,Issaquena County,,787,479,302,0.608640407,0.383735705,177,0.224904701
28057,1100,8385,9634,0.11417895,0.870354993,7285,-0.756176043,MS,Itawamba County,,8729,1599,6925,0.183182495,0.79333257,5326,-0.610150074
28059,13087,31204,45465,0.287847795,0.686330144,18117,-0.398482349,MS,Jackson County,,49290,15452,33262,0.31349158,0.674822479,17810,-0.361330899
28061,4367,4032,8468,0.515706188,0.476145489,335,0.039560699,MS,Jasper County,,9340,5097,4193,0.545717345,0.448929336,904,0.096788009
28063,3337,489,3859,0.864731796,0.126716766,2848,0.73801503,MS,Jefferson County,,3953,3508,431,0.88742727,0.109031116,3077,0.778396155
28065,3720,2466,6237,0.596440596,0.395382395,1254,0.201058201,MS,Jefferson Davis County,,6618,4094,2439,0.618615896,0.368540345,1655,0.250075552
28067,7748,20076,28250,0.274265487,0.710654867,12328,-0.436389381,MS,Jones County,,30038,9146,20635,0.304480991,0.68696318,11489,-0.382482189
28069,2827,1778,4639,0.609398577,0.383272257,1049,0.22612632,MS,Kemper County,,5052,3239,1789,0.641132225,0.354117181,1450,0.287015044
28071,7968,10872,19642,0.405661338,0.553507789,2904,-0.147846451,MS,Lafayette County,,17191,7098,9772,0.412890466,0.568436973,2674,-0.155546507
28073,5044,18493,24179,0.208610778,0.764837255,13449,-0.556226478,MS,Lamar County,,22780,5037,17472,0.221115013,0.766988586,12435,-0.545873573
28075,10910,17574,28967,0.376635482,0.606690372,6664,-0.23005489,MS,Lauderdale County,,30213,12642,17322,0.418429153,0.573329362,4680,-0.154900209
28077,2181,4072,6329,0.344604203,0.643387581,1891,-0.298783378,MS,Lawrence County,,6584,2394,4153,0.363608748,0.630771567,1759,-0.267162819
28079,3579,4775,8436,0.424253201,0.566026553,1196,-0.141773352,MS,Leake County,,7921,3599,4283,0.454361823,0.540714556,684,-0.086352733
28081,9635,21695,31974,0.301338588,0.678520048,12060,-0.37718146,MS,Lee County,,34363,12043,22004,0.350464162,0.6403399,9961,-0.289875738
28083,6677,2757,9566,0.697992891,0.288208238,3920,0.409784654,MS,Leflore County,,11600,8423,3115,0.72612069,0.268534483,5308,0.457586207
28085,4458,10550,15193,0.293424603,0.694398736,6092,-0.400974133,MS,Lincoln County,,14303,4879,9333,0.341117248,0.65252045,4454,-0.311403202
28087,11545,13124,25139,0.459246589,0.522057361,1579,-0.062810772,MS,Lowndes County,,24674,12037,12399,0.487841453,0.502512766,362,-0.014671314
28089,18358,25607,45048,0.407520867,0.56843811,7249,-0.160917244,MS,Madison County,,49571,20722,28507,0.418026669,0.575074136,7785,-0.157047467
28091,3572,7697,11443,0.312155903,0.672638294,4125,-0.360482391,MS,Marion County,,11041,3833,7118,0.347160583,0.644687981,3285,-0.297527398
28093,7944,6525,14698,0.540481698,0.443937951,1419,0.096543747,MS,Marshall County,,16141,9581,6444,0.593581562,0.39923177,3137,0.194349792
28095,5485,10107,15781,0.347569862,0.64045371,4622,-0.292883848,MS,Monroe County,,16789,6990,9661,0.416344035,0.575436298,2671,-0.159092263
28097,1775,2334,4162,0.426477655,0.560788083,559,-0.134310428,MS,Montgomery County,,4807,2245,2543,0.467027252,0.529020179,298,-0.061992927
28099,2668,7613,10438,0.255604522,0.729354282,4945,-0.47374976,MS,Neshoba County,,10890,3030,7772,0.278236915,0.713682277,4742,-0.435445363
28101,2549,5929,8594,0.296602281,0.68989993,3380,-0.39329765,MS,Newton County,,9039,3069,5909,0.339528709,0.653722757,2840,-0.314194048
28103,4330,1181,5538,0.781870711,0.213253882,3149,0.568616829,MS,Noxubee County,,6264,4920,1325,0.785440613,0.211526181,3595,0.573914432
28105,7851,7671,16151,0.486099932,0.474955111,180,0.011144821,MS,Oktibbeha County,,16001,8030,7728,0.501843635,0.482969814,302,0.01887382
28107,7300,7371,14854,0.491450114,0.496229972,71,-0.004779857,MS,Panola County,,16826,9079,7629,0.5395816,0.453405444,1450,0.086176156
28109,2919,15530,18893,0.154501667,0.821997565,12611,-0.667495898,MS,Pearl River County,,19938,3813,15836,0.191242853,0.794262213,12023,-0.60301936
28111,1220,4135,5432,0.224594993,0.76122975,2915,-0.536634757,MS,Perry County,,5686,1519,4110,0.26714738,0.722827999,2591,-0.455680619
28113,7636,7748,15633,0.488453912,0.495618243,112,-0.007164332,MS,Pike County,,17429,9304,7986,0.533822939,0.458201847,1318,0.075621091
28115,2123,9442,11811,0.179747693,0.799424266,7319,-0.619676573,MS,Pontotoc County,,12348,2785,9403,0.225542598,0.761499838,6618,-0.53595724
28117,2067,7647,9871,0.209401276,0.774693547,5580,-0.56529227,MS,Prentiss County,,10033,2817,7075,0.280773448,0.705172929,4258,-0.424399482
28119,2303,998,3353,0.686847599,0.297643901,1305,0.389203698,MS,Quitman County,,3979,2837,1116,0.712993214,0.280472481,1721,0.432520734
28121,13741,46168,61356,0.223955277,0.752461047,32427,-0.52850577,MS,Rankin County,,61438,14425,46318,0.234789544,0.753898239,31893,-0.519108695
28123,3999,5742,9867,0.405290362,0.581939799,1743,-0.176649438,MS,Scott County,,10584,4774,5728,0.451058201,0.541194255,954,-0.090136054
28125,1290,619,1926,0.669781931,0.321391485,671,0.348390447,MS,Sharkey County,,2258,1571,675,0.69574845,0.298937112,896,0.396811337
28127,3871,7393,11416,0.339085494,0.64759986,3522,-0.308514366,MS,Simpson County,,12249,4723,7424,0.385582497,0.606090293,2701,-0.220507797
28129,1598,5877,7556,0.21148756,0.777792483,4279,-0.566304923,MS,Smith County,,8099,1979,6049,0.244351154,0.746882331,4070,-0.502531177
28131,1400,4810,6368,0.219849246,0.755339196,3410,-0.53548995,MS,Stone County,,6820,1794,4924,0.263049853,0.721994135,3130,-0.458944282
28133,6560,2768,9406,0.697427174,0.294280247,3792,0.403146927,MS,Sunflower County,,10995,7989,2907,0.726603001,0.264392906,5082,0.462210095
28135,3337,2462,5870,0.568483816,0.419420784,875,0.149063032,MS,Tallahatchie County,,6363,3838,2480,0.603174603,0.389753261,1358,0.213421342
28137,3804,7385,11389,0.334006497,0.648432698,3581,-0.314426201,MS,Tate County,,11374,4572,6666,0.401969404,0.586073501,2094,-0.184104097
28139,1808,7182,9143,0.19774691,0.785518976,5374,-0.587772066,MS,Tippah County,,9008,2254,6625,0.250222025,0.735457371,4371,-0.485235346
28141,990,7117,8310,0.119133574,0.856438026,6127,-0.737304452,MS,Tishomingo County,,7850,1623,6070,0.206751592,0.773248408,4447,-0.566496815
28143,2577,840,3463,0.744152469,0.242564251,1737,0.501588218,MS,Tunica County,,4262,3371,867,0.790943219,0.203425622,2504,0.587517597
28145,1969,9161,11374,0.17311412,0.805433445,7192,-0.632319325,MS,Union County,,10359,2481,7759,0.239501882,0.749010522,5278,-0.50950864
28147,2475,3374,5909,0.418852598,0.5709934,899,-0.152140802,MS,Walthall County,,7476,3386,4012,0.452915998,0.536650615,626,-0.083734617
28149,8518,9420,18287,0.465795374,0.515120031,902,-0.049324657,MS,Warren County,,19429,9899,9390,0.509496114,0.483298163,509,0.026197952
28151,9847,4541,14571,0.675794386,0.311646421,5306,0.364147965,MS,Washington County,,17137,12188,4870,0.711209663,0.284180428,7318,0.427029235
28153,3493,5957,9534,0.366372981,0.624816446,2464,-0.258443465,MS,Wayne County,,10269,4116,6080,0.400817996,0.59207323,1964,-0.191255234
28155,1001,3949,5024,0.199243631,0.78602707,2948,-0.586783439,MS,Webster County,,4820,1087,3684,0.225518672,0.764315353,2597,-0.53879668
28157,2826,1305,4174,0.677048395,0.312649736,1521,0.364398658,MS,Wilkinson County,,4238,2940,1275,0.693723454,0.300849457,1665,0.392873997
28159,3778,4874,8771,0.430737658,0.555694904,1096,-0.124957245,MS,Winston County,,9758,4557,5147,0.467001435,0.527464644,590,-0.06046321
28161,2574,3366,6058,0.424892704,0.55562892,792,-0.130736217,MS,Yalobusha County,,6293,2984,3261,0.474177658,0.51819482,277,-0.044017162
28163,5221,4568,9892,0.527800243,0.461787303,653,0.06601294,MS,Yazoo County,,10853,6220,4560,0.573113425,0.420160324,1660,0.152953101
29001,3495,6019,10137,0.344776561,0.593765414,2524,-0.248988853,MO,Adair County,,10121,4218,5648,0.416757237,0.558047624,1430,-0.141290386
29003,2045,6665,9140,0.223741794,0.729212254,4620,-0.50547046,MO,Andrew County,,8306,2649,5457,0.318926078,0.656994943,2808,-0.338068866
29005,541,2059,2723,0.198677929,0.756151304,1518,-0.557473375,MO,Atchison County,,2709,756,1902,0.279069767,0.702104097,1146,-0.42303433
29007,2567,6981,10043,0.255600916,0.695111023,4414,-0.439510107,MO,Audrain County,,9951,3538,6186,0.355542157,0.621646066,2648,-0.266103909
29009,2710,11427,14604,0.185565598,0.782456861,8717,-0.596891263,MO,Barry County,,13806,3667,9832,0.265609155,0.712154136,6165,-0.44654498
29011,795,4958,5932,0.134018881,0.835805799,4163,-0.701786918,MO,Barton County,,5746,1232,4416,0.214410024,0.768534633,3184,-0.554124608
29013,1617,6000,8021,0.201595811,0.748036404,4383,-0.546440593,MO,Bates County,,7771,2557,5020,0.329043881,0.645991507,2463,-0.316947626
29015,2024,7212,9584,0.211185309,0.752504174,5188,-0.541318865,MO,Benton County,,9157,2925,6069,0.31942776,0.66277165,3144,-0.34334389
29017,705,4827,5669,0.124360557,0.851472923,4122,-0.727112365,MO,Bollinger County,,5455,1213,4094,0.222364803,0.750504125,2881,-0.528139322
29019,41072,36146,83312,0.492990205,0.433863069,4926,0.059127137,MO,Boone County,,79296,39782,37343,0.501689871,0.470931699,2439,0.030758172
29021,12010,21315,35563,0.337710542,0.599358884,9305,-0.261648342,MO,Buchanan County,,35106,15594,18660,0.444197573,0.531533071,3066,-0.087335498
29023,3036,13647,17232,0.176183844,0.791956825,10611,-0.615772981,MO,Butler County,,16889,4363,12248,0.258333827,0.725205755,7885,-0.466871928
29025,837,3231,4309,0.194244604,0.749825946,2394,-0.555581341,MO,Caldwell County,,4171,1313,2724,0.314792616,0.653080796,1411,-0.33828818
29027,4988,13052,19127,0.260783186,0.682386156,8064,-0.42160297,MO,Callaway County,,18228,6070,11742,0.333004169,0.644173799,5672,-0.311169629
29029,4706,16721,22182,0.212153999,0.753809395,12015,-0.541655396,MO,Camden County,,21942,6458,15089,0.294321393,0.687676602,8631,-0.393355209
29031,8468,26939,36875,0.229640678,0.730549153,18471,-0.500908475,MO,Cape Girardeau County,,35672,9713,25343,0.272286387,0.710445167,15630,-0.43815878
29033,745,3480,4361,0.170832378,0.797982114,2735,-0.627149736,MO,Carroll County,,4304,1154,3072,0.268122677,0.713754647,1918,-0.44563197
29035,436,2323,2842,0.153413089,0.817382125,1887,-0.663969036,MO,Carter County,,2799,754,1978,0.269381922,0.706680957,1224,-0.437299035
29037,14816,33006,50715,0.292142364,0.650813369,18190,-0.358671005,MO,Cass County,,48913,17044,30912,0.348455421,0.631979228,13868,-0.283523808
29039,1010,5019,6278,0.160879261,0.799458426,4009,-0.638579165,MO,Cedar County,,6043,1536,4375,0.254178388,0.723978157,2839,-0.469799768
29041,888,2948,3962,0.224129228,0.744068652,2060,-0.519939425,MO,Chariton County,,3821,1339,2402,0.350431824,0.628631248,1063,-0.278199424
29043,8505,30941,41394,0.20546456,0.74747548,22436,-0.542010919,MO,Christian County,,37952,9809,27465,0.258458052,0.723677277,17656,-0.465219224
29045,724,2458,3316,0.218335344,0.741254524,1734,-0.52291918,MO,Clark County,,3225,1398,1730,0.433488372,0.536434109,332,-0.102945736
29047,45182,57328,109237,0.413614435,0.524803867,12146,-0.111189432,MO,Clay County,,105465,47250,56131,0.448015929,0.532223961,8881,-0.084208031
29049,2572,7058,10197,0.252231048,0.692164362,4486,-0.439933314,MO,Clinton County,,9830,3685,5904,0.374872838,0.600610376,2219,-0.225737538
29051,10907,24610,37261,0.292718929,0.660476101,13703,-0.367757172,MO,Cole County,,37058,12003,24488,0.323897674,0.660801986,12485,-0.336904312
29053,1932,5623,7976,0.24222668,0.70498997,3691,-0.46276329,MO,Cooper County,,7511,2474,4887,0.329383571,0.65064572,2413,-0.321262149
29055,1824,7724,9920,0.183870968,0.778629032,5900,-0.594758065,MO,Crawford County,,9579,2951,6434,0.308069736,0.671677628,3483,-0.363607892
29057,637,3184,3951,0.161225006,0.805871931,2547,-0.644646925,MO,Dade County,,3896,939,2895,0.241016427,0.743069815,1956,-0.502053388
29059,1271,5895,7440,0.170833333,0.79233871,4624,-0.621505376,MO,Dallas County,,7279,2122,4992,0.291523561,0.68580849,2870,-0.394284929
29061,730,2763,3689,0.197885606,0.748983464,2033,-0.551097858,MO,Daviess County,,3512,1124,2282,0.320045558,0.64977221,1158,-0.329726651
29063,824,3540,4590,0.179520697,0.77124183,2716,-0.591721133,MO,DeKalb County,,4350,1194,3056,0.274482759,0.702528736,1862,-0.428045977
29065,978,5599,6778,0.144290351,0.826054883,4621,-0.681764532,MO,Dent County,,6643,1585,4883,0.238597019,0.735059461,3298,-0.496462442
29067,984,5486,6664,0.147659064,0.823229292,4502,-0.675570228,MO,Douglas County,,6556,1709,4649,0.260677242,0.709121415,2940,-0.448444173
29069,2360,8026,10574,0.223188954,0.759031587,5666,-0.535842633,MO,Dunklin County,,10649,3635,6849,0.341346605,0.643158982,3214,-0.301812377
29071,12339,35420,50045,0.246558098,0.707763013,23081,-0.461204916,MO,Franklin County,,46573,16294,29271,0.349859361,0.628497198,12977,-0.278637837
29073,1519,5670,7444,0.204056959,0.761687265,4151,-0.557630306,MO,Gasconade County,,7134,2099,4895,0.294224839,0.686150827,2796,-0.391925988
29075,605,2304,3033,0.19947247,0.759643917,1699,-0.560171447,MO,Gentry County,,2997,937,1986,0.312645979,0.662662663,1049,-0.350016683
29077,42400,77387,127609,0.332264966,0.606438417,34987,-0.274173452,MO,Greene County,,125639,46130,76786,0.367163062,0.611163731,30656,-0.244000669
29079,780,3462,4413,0.17675051,0.78450034,2682,-0.60774983,MO,Grundy County,,4374,1212,3030,0.277091907,0.692729767,1818,-0.41563786
29081,574,2965,3682,0.155893536,0.805268876,2391,-0.649375339,MO,Harrison County,,3695,984,2624,0.266305819,0.71014885,1640,-0.443843031
29083,2356,7072,9855,0.239066464,0.717605277,4716,-0.478538813,MO,Henry County,,10121,3604,6229,0.356091295,0.615453018,2625,-0.259361723
29085,1016,3539,4717,0.215391138,0.750264999,2523,-0.534873861,MO,Hickory County,,4680,1733,2835,0.370299145,0.605769231,1102,-0.235470085
29087,346,1926,2348,0.147359455,0.820272572,1580,-0.672913118,MO,Holt County,,2310,551,1725,0.238528139,0.746753247,1174,-0.508225108
29089,1279,3277,4851,0.263656978,0.675530818,1998,-0.41187384,MO,Howard County,,4861,1722,3012,0.354248097,0.619625591,1290,-0.265377494
29091,2880,13888,17415,0.165374677,0.797473442,11008,-0.632098765,MO,Howell County,,16341,4393,11541,0.268832997,0.706260327,7148,-0.43742733
29093,933,3173,4260,0.219014085,0.744835681,2240,-0.525821596,MO,Iron County,,4031,1669,2252,0.414041181,0.558670305,583,-0.144629124
29095,163723,114777,294063,0.556761646,0.39031432,48946,0.166447326,MO,Jackson County,,306854,180100,121891,0.586924075,0.397227998,58209,0.189696077
29097,10565,35058,48179,0.219286411,0.727661429,24493,-0.508375018,MO,Jasper County,,45213,12808,31345,0.283281357,0.693274058,18537,-0.409992701
29099,31546,68973,105969,0.297690834,0.650879031,37427,-0.353188197,MO,Jefferson County,,97613,41570,53973,0.425865407,0.552928401,12403,-0.127062994
29101,5924,13702,21087,0.28093138,0.649784227,7778,-0.368852848,MO,Johnson County,,21001,7661,12750,0.364792153,0.607113947,5089,-0.242321794
29103,379,1413,1867,0.202999464,0.756829138,1034,-0.553829673,MO,Knox County,,1957,698,1205,0.35666837,0.615738375,507,-0.259070005
29105,2543,12834,15959,0.159345824,0.804185726,10291,-0.644839902,MO,Laclede County,,15361,4093,10934,0.266454007,0.711802617,6841,-0.44534861
29107,4047,10977,15815,0.255896301,0.694087891,6930,-0.43819159,MO,Lafayette County,,15786,5650,9800,0.357912074,0.620803243,4150,-0.262891169
29109,2898,13084,16674,0.173803526,0.784694734,10186,-0.610891208,MO,Lawrence County,,15748,4014,11417,0.25488951,0.72498095,7403,-0.47009144
29111,933,3343,4452,0.209568733,0.750898473,2410,-0.541329739,MO,Lewis County,,4278,1507,2677,0.352267415,0.625759701,1170,-0.273492286
29113,5561,18111,24857,0.223719677,0.728607636,12550,-0.504887959,MO,Lincoln County,,22649,7733,14330,0.341427878,0.632699015,6597,-0.291271138
29115,1239,4084,5572,0.222361809,0.732950467,2845,-0.510588658,MO,Linn County,,5527,2031,3331,0.36746879,0.602677764,1300,-0.235208974
29117,1265,4879,6408,0.197409488,0.76139201,3614,-0.563982522,MO,Livingston County,,6054,1906,4006,0.314833168,0.661711265,2100,-0.346878097
29119,1329,6599,8233,0.161423539,0.801530426,5270,-0.640106887,MO,McDonald County,,7817,1920,5694,0.245618524,0.728412434,3774,-0.482793911
29121,1518,5794,7579,0.200290276,0.764480802,4276,-0.564190526,MO,Macon County,,7159,2309,4700,0.32253108,0.656516273,2391,-0.333985193
29123,1005,4102,5318,0.18898082,0.77134261,3097,-0.58236179,MO,Madison County,,4930,1588,3227,0.322109533,0.654563895,1639,-0.332454361
29125,794,3559,4498,0.176522899,0.791240551,2765,-0.614717652,MO,Maries County,,4538,1299,3165,0.286249449,0.697443808,1866,-0.411194359
29127,2993,9418,12902,0.231979538,0.729964347,6425,-0.497984809,MO,Marion County,,12164,4034,7926,0.331634331,0.65159487,3892,-0.319960539
29129,216,1486,1739,0.124209316,0.854514089,1270,-0.730304773,MO,Mercer County,,1655,353,1255,0.213293051,0.758308157,902,-0.545015106
29131,1750,9285,11414,0.153320484,0.81347468,7535,-0.660154197,MO,Miller County,,11019,2651,8099,0.240584445,0.735003176,5448,-0.494418731
29133,1458,3600,5165,0.282284608,0.696999032,2142,-0.414714424,MO,Mississippi County,,4918,1857,2996,0.377592517,0.609190728,1139,-0.231598211
29135,1237,5344,6808,0.181698002,0.784958872,4107,-0.60326087,MO,Moniteau County,,6442,1608,4703,0.249611922,0.730052779,3095,-0.480440857
29137,853,3159,4147,0.205690861,0.761755486,2306,-0.556064625,MO,Monroe County,,4057,1398,2564,0.344589598,0.631994084,1166,-0.287404486
29139,1118,4124,5424,0.206120944,0.760324484,3006,-0.55420354,MO,Montgomery County,,5317,1734,3486,0.326123754,0.655632876,1752,-0.329509122
29141,1768,6757,8815,0.200567215,0.766534317,4989,-0.565967102,MO,Morgan County,,8688,2773,5733,0.319175875,0.659875691,2960,-0.340699816
29143,1933,5270,7352,0.262921654,0.716811752,3337,-0.453890098,MO,New Madrid County,,7250,2814,4284,0.388137931,0.590896552,1470,-0.202758621
29145,4988,20546,26506,0.188183807,0.77514525,15558,-0.586961443,MO,Newton County,,25080,6425,18179,0.256180223,0.72484051,11754,-0.468660287
29147,2529,6379,9439,0.267930925,0.675813116,3850,-0.407882191,MO,Nodaway County,,8976,3172,5593,0.353386809,0.623106061,2421,-0.269719251
29149,865,3668,4664,0.185463122,0.7864494,2803,-0.600986278,MO,Oregon County,,4421,1419,2886,0.320968107,0.652793486,1467,-0.331825379
29151,998,5845,7078,0.141000283,0.825798248,4847,-0.684797966,MO,Osage County,,6918,1472,5330,0.21277826,0.770453888,3858,-0.557675629
29153,724,3639,4501,0.160853144,0.808487003,2915,-0.647633859,MO,Ozark County,,4453,1261,3080,0.283179879,0.691668538,1819,-0.408488659
29155,1946,3964,6025,0.322987552,0.657925311,2018,-0.334937759,MO,Pemiscot County,,6333,2671,3596,0.42175904,0.567819359,925,-0.146060319
29157,1520,6907,8732,0.174072377,0.790998626,5387,-0.616926248,MO,Perry County,,7987,2184,5669,0.273444347,0.70977839,3485,-0.436334043
29159,4322,12792,18045,0.23951233,0.708894431,8470,-0.4693821,MO,Pettis County,,17171,5902,10840,0.343719061,0.631296954,4938,-0.287577893
29161,4761,12699,18499,0.257365263,0.686469539,7938,-0.429104276,MO,Phelps County,,18188,5798,11893,0.318781614,0.653892676,6095,-0.335111062
29163,1806,5274,7375,0.244881356,0.715118644,3468,-0.470237288,MO,Pike County,,7319,2581,4576,0.352643804,0.625222025,1995,-0.272578221
29165,18915,24975,46641,0.405544478,0.535473082,6060,-0.129928604,MO,Platte County,,45547,19171,25617,0.420905877,0.562430017,6446,-0.14152414
29167,2630,10435,13709,0.191844774,0.761178788,7805,-0.569334014,MO,Polk County,,13119,3580,9252,0.272886653,0.70523668,5672,-0.432350027
29169,2918,9870,13443,0.217064643,0.734211114,6952,-0.51714647,MO,Pulaski County,,13571,4199,9092,0.309409771,0.669957999,4893,-0.360548228
29171,352,1936,2342,0.15029889,0.826643894,1584,-0.676345004,MO,Putnam County,,2309,587,1673,0.254222607,0.724556085,1086,-0.470333478
29173,1138,3969,5266,0.216103304,0.753703,2831,-0.537599696,MO,Ralls County,,5036,1736,3231,0.34471803,0.64158062,1495,-0.296862589
29175,2283,7529,10309,0.221456979,0.730332719,5246,-0.50887574,MO,Randolph County,,9944,3031,6667,0.304806919,0.670454545,3636,-0.365647627
29177,3088,7103,10835,0.285002307,0.655560683,4015,-0.370558376,MO,Ray County,,10346,4264,5805,0.412139957,0.56108641,1541,-0.148946453
29179,540,2402,3032,0.178100264,0.792216359,1862,-0.614116095,MO,Reynolds County,,3196,1155,1927,0.361389237,0.602941176,772,-0.24155194
29181,830,4520,5518,0.150416818,0.819137369,3690,-0.668720551,MO,Ripley County,,5263,1396,3743,0.265247957,0.711191336,2347,-0.445943378
29183,68225,120899,199513,0.341957667,0.605970538,52674,-0.264012871,MO,St. Charles County,,185597,71798,110732,0.386848925,0.596626023,38934,-0.209777098
29185,936,3501,4630,0.202159827,0.756155508,2565,-0.55399568,MO,St. Clair County,,4626,1460,3019,0.315607436,0.652615651,1559,-0.337008214
29186,2540,5495,8459,0.3002719,0.649603972,2955,-0.349332072,MO,Ste. Genevieve County,,8070,3813,4055,0.472490706,0.502478315,242,-0.029987608
29187,6250,17467,24714,0.252893097,0.706765396,11217,-0.453872299,MO,St. Francois County,,22590,8837,13248,0.391190792,0.586454183,4411,-0.195263391
29189,280866,199081,503493,0.557834965,0.395399737,81785,0.162435228,MO,St. Louis County,,524628,294735,223102,0.561798074,0.425257516,71633,0.136540558
29195,2787,5977,9245,0.301460249,0.646511628,3190,-0.345051379,MO,Saline County,,9095,3785,5096,0.416162727,0.560307861,1311,-0.144145135
29197,354,1505,1933,0.183135023,0.778582514,1151,-0.595447491,MO,Schuyler County,,1939,697,1174,0.359463641,0.605466735,477,-0.246003094
29199,365,1525,1968,0.18546748,0.774898374,1160,-0.589430894,MO,Scotland County,,1936,643,1246,0.332128099,0.643595041,603,-0.311466942
29201,3574,13168,17244,0.207260496,0.763627929,9594,-0.556367432,MO,Scott County,,16999,5122,11623,0.301311842,0.683746103,6501,-0.382434261
29203,776,2966,3904,0.198770492,0.759733607,2190,-0.560963115,MO,Shannon County,,3688,1300,2260,0.352494577,0.612798265,960,-0.260303688
29205,606,2524,3252,0.186346863,0.776137761,1918,-0.589790898,MO,Shelby County,,3232,966,2188,0.298886139,0.676980198,1222,-0.378094059
29207,1873,11077,13278,0.141060401,0.834237084,9204,-0.693176683,MO,Stoddard County,,12866,3153,9496,0.245064511,0.73806933,6343,-0.493004819
29209,2886,13149,16538,0.174507196,0.795078002,10263,-0.620570807,MO,Stone County,,15974,3920,11780,0.245398773,0.737448354,7860,-0.492049581
29211,526,1884,2484,0.211755233,0.758454106,1358,-0.546698873,MO,Sullivan County,,2595,908,1610,0.349903661,0.620423892,702,-0.270520231
29213,4367,18240,23399,0.186631907,0.779520492,13873,-0.592888585,MO,Taney County,,21608,5462,15713,0.252776749,0.727184376,10251,-0.474407627
29215,1728,8875,10935,0.158024691,0.811614083,7147,-0.653589392,MO,Texas County,,10764,2871,7618,0.266722408,0.707729469,4747,-0.441007061
29217,1706,6526,8576,0.198927239,0.760960821,4820,-0.562033582,MO,Vernon County,,8519,2580,5756,0.302852447,0.675666158,3176,-0.372813711
29219,3915,11109,15766,0.248319168,0.704617531,7194,-0.456298364,MO,Warren County,,14676,5219,9150,0.355614609,0.623466885,3931,-0.267852276
29221,1926,7047,9279,0.20756547,0.759456838,5121,-0.551891368,MO,Washington County,,8616,3402,5008,0.394846797,0.581244197,1606,-0.1863974
29223,946,4640,5738,0.164865807,0.808644127,3694,-0.64377832,MO,Wayne County,,5718,1811,3790,0.316719133,0.662819168,1979,-0.346100035
29225,3173,12829,16690,0.190113841,0.768663871,9656,-0.57855003,MO,Webster County,,15421,4407,10702,0.285779132,0.693988717,6295,-0.408209584
29227,195,808,1046,0.186424474,0.772466539,613,-0.586042065,MO,Worth County,,1048,341,664,0.325381679,0.633587786,323,-0.308206107
29229,1166,6703,8086,0.144199852,0.828963641,5537,-0.684763789,MO,Wright County,,7956,1953,5831,0.245475113,0.732905983,3878,-0.48743087
29510,101487,20281,127403,0.796582498,0.159187774,81206,0.637394724,MO,St. Louis city,,141135,116654,22617,0.826541963,0.160250824,94037,0.66629114
30001,1115,3243,4676,0.238451668,0.693541488,2128,-0.45508982,MT,Beaverhead County,,4749,1347,3251,0.283638661,0.684565172,1904,-0.400926511
30003,2061,1833,4148,0.496865959,0.441899711,228,0.054966249,MT,Big Horn County,,4561,2830,1655,0.620477965,0.362859022,1175,0.257618943
30005,1187,1259,2621,0.45288058,0.480351011,72,-0.027470431,MT,Blaine County,,2832,1598,1169,0.564265537,0.412782486,429,0.151483051
30007,566,2329,3097,0.182757507,0.752018082,1763,-0.569260575,MT,Broadwater County,,3005,761,2150,0.253244592,0.71547421,1389,-0.462229617
30009,1824,3729,5923,0.307952051,0.629579605,1905,-0.321627554,MT,Carbon County,,5806,2126,3513,0.366172925,0.605063727,1387,-0.238890803
30011,70,677,777,0.09009009,0.871299871,607,-0.781209781,MT,Carter County,,794,96,678,0.120906801,0.853904282,582,-0.732997481
30013,12053,19343,33791,0.35669261,0.572430529,7290,-0.215737918,MT,Cascade County,,33952,14949,18039,0.440298068,0.531308907,3090,-0.091010839
30015,729,1676,2571,0.283547258,0.651886426,947,-0.368339168,MT,Chouteau County,,2804,969,1751,0.345577746,0.62446505,782,-0.278887304
30017,1172,3638,5145,0.227793975,0.707094266,2466,-0.479300292,MT,Custer County,,5336,1824,3353,0.341829085,0.628373313,1529,-0.286544228
30019,167,729,952,0.175420168,0.765756303,562,-0.590336134,MT,Daniels County,,1001,236,735,0.235764236,0.734265734,499,-0.498501499
30021,786,3298,4297,0.182918315,0.767512218,2512,-0.584593903,MT,Dawson County,,4417,1219,3024,0.275979171,0.684627575,1805,-0.408648404
30023,2018,1736,4099,0.492315199,0.423517931,282,0.068797268,MT,Deer Lodge County,,4408,2829,1431,0.641787659,0.324637024,1398,0.317150635
30025,154,1276,1474,0.104477612,0.865671642,1122,-0.76119403,MT,Fallon County,,1399,236,1123,0.168691923,0.802716226,887,-0.634024303
30027,1196,4235,5782,0.206848841,0.732445521,3039,-0.525596679,MT,Fergus County,,6044,1628,4243,0.269358041,0.702018531,2615,-0.43266049
30029,13233,30079,46144,0.286776179,0.651850728,16846,-0.365074549,MT,Flathead County,,42465,13534,27694,0.318709525,0.652160603,14160,-0.333451077
30031,23879,23360,52169,0.457723936,0.447775499,519,0.009948437,MT,Gallatin County,,47113,21534,24051,0.457071297,0.510496041,2517,-0.053424745
30033,34,653,715,0.047552448,0.913286713,619,-0.865734266,MT,Garfield County,,700,66,622,0.094285714,0.888571429,556,-0.794285714
30035,3076,1598,4969,0.619038036,0.321593882,1478,0.297444154,MT,Glacier County,,4287,2784,1391,0.649405178,0.324469326,1393,0.324935853
30037,71,365,468,0.151709402,0.77991453,294,-0.628205128,MT,Golden Valley County,,479,110,351,0.229645094,0.732776618,241,-0.503131524
30039,469,1185,1762,0.266174801,0.672531215,716,-0.406356413,MT,Granite County,,1705,533,1107,0.312609971,0.649266862,574,-0.336656891
30041,2350,3446,6347,0.370253663,0.542933669,1096,-0.172680006,MT,Hill County,,6757,3372,3133,0.499038035,0.463667308,239,0.035370727
30043,1975,4099,6535,0.302218822,0.62723795,2124,-0.325019128,MT,Jefferson County,,6490,2256,4042,0.34761171,0.622804314,1786,-0.275192604
30045,232,867,1189,0.195121951,0.729184188,635,-0.534062237,MT,Judith Basin County,,1212,336,852,0.277227723,0.702970297,516,-0.425742574
30047,4703,7453,12898,0.364630175,0.577841526,2750,-0.213211351,MT,Lake County,,13156,5715,7084,0.434402554,0.538461538,1369,-0.104058984
30049,14331,16665,33697,0.425290085,0.494554411,2334,-0.069264326,MT,Lewis and Clark County,,33032,15479,16673,0.4686062,0.504752967,1194,-0.036146767
30051,205,695,949,0.21601686,0.732349842,490,-0.516332982,MT,Liberty County,,983,257,698,0.261444557,0.710071211,441,-0.448626653
30053,2040,6720,9250,0.220540541,0.726486486,4680,-0.505945946,MT,Lincoln County,,8869,2544,6045,0.286841809,0.681587552,3501,-0.394745744
30055,154,858,1056,0.145833333,0.8125,704,-0.666666667,MT,McCone County,,988,221,742,0.223684211,0.751012146,521,-0.527327935
30057,1175,3280,4708,0.249575191,0.696686491,2105,-0.4471113,MT,Madison County,,4511,1285,3115,0.284859233,0.69053425,1830,-0.405675017
30059,191,728,970,0.196907216,0.750515464,537,-0.553608247,MT,Meagher County,,972,269,670,0.276748971,0.689300412,401,-0.41255144
30061,515,1322,1974,0.260891591,0.66970618,807,-0.40881459,MT,Mineral County,,2009,698,1212,0.347436536,0.603285217,514,-0.255848681
30063,30740,21699,57271,0.536746346,0.378882855,9041,0.157863491,MT,Missoula County,,59374,34380,23285,0.579041331,0.392175026,11095,0.186866305
30065,331,1961,2404,0.137687188,0.815723794,1630,-0.678036606,MT,Musselshell County,,2353,482,1792,0.204844879,0.76158096,1310,-0.556736082
30067,3521,4872,9056,0.388803004,0.537985866,1351,-0.149182862,MT,Park County,,8634,3728,4637,0.43178133,0.537062775,909,-0.105281445
30069,30,276,319,0.094043887,0.865203762,246,-0.771159875,MT,Petroleum County,,298,49,240,0.16442953,0.805369128,191,-0.640939597
30071,315,1715,2147,0.146716348,0.798789008,1400,-0.65207266,MT,Phillips County,,2228,471,1688,0.211400359,0.757630162,1217,-0.546229803
30073,737,1786,2692,0.273774146,0.663447251,1049,-0.389673105,MT,Pondera County,,2704,969,1666,0.358357988,0.61612426,697,-0.257766272
30075,127,880,1047,0.121298949,0.840496657,753,-0.719197708,MT,Powder River County,,1019,170,833,0.166830226,0.817468106,663,-0.65063788
30077,549,2017,2768,0.19833815,0.728684971,1468,-0.530346821,MT,Powell County,,2763,884,1798,0.319942092,0.650741947,914,-0.330799855
30079,100,555,686,0.145772595,0.809037901,455,-0.663265306,MT,Prairie County,,701,167,518,0.238231098,0.738944365,351,-0.500713267
30081,6166,14673,22063,0.27947242,0.665050084,8507,-0.385577664,MT,Ravalli County,,19797,6466,12817,0.326615144,0.647421326,6351,-0.320806183
30083,669,3885,4812,0.139027431,0.807356608,3216,-0.668329177,MT,Richland County,,4602,992,3479,0.215558453,0.755975663,2487,-0.54041721
30085,1504,1722,3486,0.431440046,0.493975904,218,-0.062535858,MT,Roosevelt County,,3618,2044,1503,0.564953013,0.415422886,541,0.149530127
30087,969,2211,3357,0.288650581,0.658623771,1242,-0.36997319,MT,Rosebud County,,3610,1478,2035,0.409418283,0.563711911,557,-0.154293629
30089,1211,4268,5871,0.206268097,0.726963039,3057,-0.520694941,MT,Sanders County,,5888,1716,3971,0.291440217,0.674422554,2255,-0.382982337
30091,476,1237,1825,0.260821918,0.677808219,761,-0.416986301,MT,Sheridan County,,1920,661,1203,0.344270833,0.6265625,542,-0.282291667
30093,8545,6252,16122,0.530021089,0.387793078,2293,0.142228011,MT,Silver Bow County,,16617,10782,5374,0.648853584,0.323403743,5408,0.325449841
30095,904,3630,4816,0.187707641,0.753737542,2726,-0.5660299,MT,Stillwater County,,4560,1209,3237,0.265131579,0.709868421,2028,-0.444736842
30097,398,1580,2077,0.191622532,0.760712566,1182,-0.569090034,MT,Sweet Grass County,,2105,473,1584,0.224703088,0.752494062,1111,-0.527790974
30099,803,2152,3143,0.255488387,0.68469615,1349,-0.429207763,MT,Teton County,,3250,1073,2091,0.330153846,0.643384615,1018,-0.313230769
30101,399,1495,2018,0.197720515,0.740832507,1096,-0.543111992,MT,Toole County,,2102,582,1440,0.276879163,0.685061846,858,-0.408182683
30103,59,350,441,0.133786848,0.793650794,291,-0.659863946,MT,Treasure County,,453,114,317,0.251655629,0.699779249,203,-0.44812362
30105,886,2697,3860,0.229533679,0.698704663,1811,-0.469170984,MT,Valley County,,3860,1386,2337,0.359067358,0.605440415,951,-0.246373057
30107,179,698,932,0.192060086,0.748927039,519,-0.556866953,MT,Wheatland County,,989,272,690,0.275025278,0.697674419,418,-0.422649141
30109,55,460,533,0.103189493,0.8630394,405,-0.759849906,MT,Wibaux County,,544,25,421,0.045955882,0.773897059,396,-0.727941176
30111,21117,38675,64675,0.32650947,0.59798995,17558,-0.271480479,MT,Yellowstone County,,68561,26275,40421,0.383235367,0.589562579,14146,-0.206327212
31001,3272,9205,13172,0.248405709,0.698830853,5933,-0.450425144,NE,Adams County,,12451,3991,8235,0.320536503,0.661392659,4244,-0.340856156
31003,381,2717,3220,0.118322981,0.84378882,2336,-0.725465839,NE,Antelope County,,3209,571,2585,0.177937052,0.805546899,2014,-0.627609847
31005,16,237,263,0.060836502,0.901140684,221,-0.840304183,NE,Arthur County,,261,30,227,0.114942529,0.869731801,197,-0.754789272
31007,18,355,390,0.046153846,0.91025641,337,-0.864102564,NE,Banner County,,402,55,339,0.13681592,0.843283582,284,-0.706467662
31009,30,273,313,0.095846645,0.872204473,243,-0.776357827,NE,Blaine County,,301,29,268,0.096345515,0.890365449,239,-0.794019934
31011,414,2299,2867,0.144401814,0.801883502,1885,-0.657481688,NE,Boone County,,2799,615,2136,0.219721329,0.763129689,1521,-0.54340836
31013,953,3550,4761,0.200168032,0.745641672,2597,-0.54547364,NE,Box Butte County,,4541,1634,2795,0.359832636,0.615503193,1161,-0.255670557
31015,128,978,1142,0.112084063,0.856392294,850,-0.744308231,NE,Boyd County,,1047,186,852,0.17765043,0.813753582,666,-0.636103152
31017,153,1380,1579,0.09689677,0.873970868,1227,-0.777074098,NE,Brown County,,1545,223,1298,0.14433657,0.84012945,1075,-0.69579288
31019,4690,14424,20477,0.229037457,0.704400059,9734,-0.475362602,NE,Buffalo County,,19057,5266,13378,0.276328908,0.701999265,8112,-0.425670357
31021,928,2360,3523,0.263411865,0.669883622,1432,-0.406471757,NE,Burt County,,3343,1280,2016,0.38288962,0.603051152,736,-0.220161532
31023,690,3068,3914,0.17629024,0.783852836,2378,-0.607562596,NE,Butler County,,3818,1028,2729,0.269250917,0.714772132,1701,-0.445521215
31025,3461,8388,12609,0.274486478,0.665239115,4927,-0.390752637,NE,Cass County,,11952,4298,7453,0.359605087,0.623577644,3155,-0.263972557
31027,572,3533,4360,0.131192661,0.810321101,2961,-0.67912844,NE,Cedar County,,4260,952,3231,0.223474178,0.758450704,2279,-0.534976526
31029,171,1621,1851,0.092382496,0.875742842,1450,-0.783360346,NE,Chase County,,1849,252,1573,0.136289886,0.850730124,1321,-0.714440238
31031,317,2623,3082,0.102855289,0.851070733,2306,-0.748215445,NE,Cherry County,,3052,436,2557,0.142857143,0.837811271,2121,-0.694954128
31033,702,3610,4569,0.153644123,0.790107244,2908,-0.636463121,NE,Cheyenne County,,4197,983,3134,0.234214915,0.74672385,2151,-0.512508935
31035,470,2373,2973,0.158089472,0.798183653,1903,-0.640094181,NE,Clay County,,2916,662,2213,0.22702332,0.758916324,1551,-0.531893004
31037,857,2171,3172,0.270176545,0.68442623,1314,-0.414249685,NE,Colfax County,,3047,959,2045,0.314735806,0.671151953,1086,-0.356416147
31039,712,3095,3988,0.178535607,0.776078235,2383,-0.597542628,NE,Cuming County,,3928,1015,2858,0.258401222,0.727596741,1843,-0.469195519
31041,635,4616,5489,0.115685917,0.840954637,3981,-0.725268719,NE,Custer County,,5414,1066,4251,0.196896934,0.785186553,3185,-0.58828962
31043,2904,4028,7259,0.400055104,0.554897369,1124,-0.154842265,NE,Dakota County,,5977,2831,3048,0.473648988,0.509954827,217,-0.036305839
31045,785,2559,3578,0.219396311,0.715204025,1774,-0.495807714,NE,Dawes County,,3634,1102,2435,0.303247111,0.670060539,1333,-0.366813429
31047,2116,5935,8486,0.249351874,0.699387226,3819,-0.450035352,NE,Dawson County,,7680,2157,5370,0.280859375,0.69921875,3213,-0.418359375
31049,120,809,977,0.122824974,0.828045036,689,-0.705220061,NE,Deuel County,,1012,215,763,0.212450593,0.753952569,548,-0.541501976
31051,556,2041,2744,0.202623907,0.743804665,1485,-0.541180758,NE,Dixon County,,2666,870,1745,0.326331583,0.654538635,875,-0.328207052
31053,4451,9736,14959,0.297546627,0.650845645,5285,-0.353299017,NE,Dodge County,,14759,5588,8937,0.378616437,0.60552883,3349,-0.226912392
31055,105207,102151,219531,0.479235279,0.465314694,3056,0.013920585,NE,Douglas County,,210501,99261,108319,0.471546453,0.514577128,9058,-0.043030674
31057,89,823,949,0.093782929,0.867228662,734,-0.773445732,NE,Dundy County,,981,176,791,0.179408767,0.806320082,615,-0.626911315
31059,610,2100,2879,0.211879125,0.729419937,1490,-0.517540813,NE,Fillmore County,,2815,794,1972,0.282060391,0.70053286,1178,-0.418472469
31061,250,1345,1656,0.150966184,0.812198068,1095,-0.661231884,NE,Franklin County,,1527,381,1110,0.249508841,0.726915521,729,-0.47740668
31063,161,1106,1310,0.122900763,0.844274809,945,-0.721374046,NE,Frontier County,,1422,381,1005,0.267932489,0.706751055,624,-0.438818565
31065,304,1915,2315,0.131317495,0.827213823,1611,-0.695896328,NE,Furnas County,,2215,422,1767,0.190519187,0.797742664,1345,-0.607223476
31067,2930,6333,9854,0.297341181,0.642683174,3403,-0.345341993,NE,Gage County,,9552,3870,5470,0.405150754,0.572654941,1600,-0.167504188
31069,153,869,1063,0.143932267,0.817497648,716,-0.673565381,NE,Garden County,,1088,242,829,0.222426471,0.761948529,587,-0.539522059
31071,121,819,968,0.125,0.84607438,698,-0.72107438,NE,Garfield County,,928,147,762,0.158405172,0.82112069,615,-0.662715517
31073,165,792,1000,0.165,0.792,627,-0.627,NE,Gosper County,,975,230,732,0.235897436,0.750769231,502,-0.514871795
31075,20,367,394,0.050761421,0.931472081,347,-0.88071066,NE,Grant County,,363,30,322,0.082644628,0.887052342,292,-0.804407713
31077,210,911,1165,0.180257511,0.781974249,701,-0.601716738,NE,Greeley County,,1181,340,820,0.287891617,0.694326842,480,-0.406435224
31079,6142,14139,21331,0.287937743,0.662838123,7997,-0.37490038,NE,Hall County,,19721,6971,12412,0.353481061,0.629379849,5441,-0.275898788
31081,873,3763,4902,0.178090575,0.767645859,2890,-0.589555284,NE,Hamilton County,,4824,1136,3582,0.235489221,0.742537313,2446,-0.507048093
31083,219,1302,1582,0.138432364,0.82300885,1083,-0.684576485,NE,Harlan County,,1584,311,1248,0.196338384,0.787878788,937,-0.591540404
31085,30,471,510,0.058823529,0.923529412,441,-0.864705882,NE,Hayes County,,535,50,473,0.093457944,0.88411215,423,-0.790654206
31087,158,1216,1440,0.109722222,0.844444444,1058,-0.734722222,NE,Hitchcock County,,1739,310,1386,0.17826337,0.797009776,1076,-0.618746406
31089,522,4275,4979,0.104840329,0.858606146,3753,-0.753765816,NE,Holt County,,4749,862,3789,0.181511897,0.797852179,2927,-0.616340282
31091,40,355,414,0.096618357,0.857487923,315,-0.760869565,NE,Hooker County,,394,59,330,0.149746193,0.837563452,271,-0.687817259
31093,544,2284,2958,0.183908046,0.77214334,1740,-0.588235294,NE,Howard County,,2856,914,1890,0.320028011,0.661764706,976,-0.341736695
31095,831,2387,3430,0.242274052,0.695918367,1556,-0.453644315,NE,Jefferson County,,3416,1185,2156,0.346896956,0.631147541,971,-0.284250585
31097,560,1348,2051,0.273037543,0.657240371,788,-0.384202828,NE,Johnson County,,2057,790,1223,0.384054448,0.594555177,433,-0.210500729
31099,550,2519,3242,0.169648365,0.776989513,1969,-0.607341147,NE,Kearney County,,3156,761,2341,0.24112801,0.741761724,1580,-0.500633714
31101,560,3203,3945,0.141951838,0.811913815,2643,-0.669961977,NE,Keith County,,4026,920,3036,0.228514655,0.754098361,2116,-0.525583706
31103,39,458,514,0.075875486,0.891050584,419,-0.815175097,NE,Keya Paha County,,481,80,392,0.166320166,0.814968815,312,-0.648648649
31105,227,1317,1636,0.138753056,0.805012225,1090,-0.666259169,NE,Kimball County,,1665,391,1222,0.234834835,0.733933934,831,-0.499099099
31107,715,3181,4061,0.176065009,0.783304605,2466,-0.607239596,NE,Knox County,,4015,1055,2878,0.262764633,0.716811955,1823,-0.454047323
31109,60533,60456,129803,0.466345154,0.465751947,77,0.000593207,NE,Lancaster County,,123206,59970,61177,0.486745775,0.496542376,1207,-0.009796601
31111,2878,11992,15674,0.18361618,0.765088682,9114,-0.581472502,NE,Lincoln County,,15266,4350,10545,0.284946941,0.690750688,6195,-0.405803747
31113,32,400,451,0.070953437,0.88691796,368,-0.815964523,NE,Logan County,,431,68,356,0.157772622,0.825986079,288,-0.668213457
31115,48,323,382,0.12565445,0.845549738,275,-0.719895288,NE,Loup County,,356,62,290,0.174157303,0.814606742,228,-0.640449438
31117,14,257,286,0.048951049,0.898601399,243,-0.84965035,NE,McPherson County,,290,41,237,0.14137931,0.817241379,196,-0.675862069
31119,2663,10518,13956,0.190813987,0.753654342,7855,-0.562840355,NE,Madison County,,13512,3368,9874,0.249259917,0.730757845,6506,-0.481497928
31121,601,2914,3707,0.162125708,0.786080388,2313,-0.62395468,NE,Merrick County,,3457,921,2477,0.266415968,0.716517211,1556,-0.450101244
31123,282,1788,2166,0.130193906,0.825484765,1506,-0.695290859,NE,Morrill County,,2152,450,1658,0.209107807,0.770446097,1208,-0.56133829
31125,280,1257,1599,0.175109443,0.786116323,977,-0.611006879,NE,Nance County,,1604,477,1098,0.297381546,0.684538653,621,-0.387157107
31127,765,2068,3035,0.252059308,0.681383855,1303,-0.429324547,NE,Nemaha County,,3126,1089,1979,0.348368522,0.633077415,890,-0.284708893
31129,348,1709,2153,0.161634928,0.793776126,1361,-0.632141198,NE,Nuckolls County,,2170,567,1563,0.261290323,0.720276498,996,-0.458986175
31131,2017,4833,7279,0.277098503,0.66396483,2816,-0.386866328,NE,Otoe County,,6905,2542,4226,0.36813903,0.612020275,1684,-0.243881245
31133,279,970,1314,0.212328767,0.738203957,691,-0.52587519,NE,Pawnee County,,1330,396,897,0.297744361,0.67443609,501,-0.376691729
31135,160,1202,1418,0.112834979,0.847672779,1042,-0.7348378,NE,Perkins County,,1391,237,1133,0.170381021,0.814521927,896,-0.644140906
31137,571,3832,4609,0.123888045,0.831416793,3261,-0.707528748,NE,Phelps County,,4336,875,3372,0.201798893,0.777675277,2497,-0.575876384
31139,382,3052,3580,0.106703911,0.852513966,2670,-0.745810056,NE,Pierce County,,3414,637,2707,0.186584651,0.792911541,2070,-0.606326889
31141,2612,10864,14047,0.185947177,0.773403574,8252,-0.587456396,NE,Platte County,,13249,3095,9963,0.233602536,0.751981282,6868,-0.518378746
31143,411,2019,2538,0.161938534,0.795508274,1608,-0.63356974,NE,Polk County,,2446,527,1886,0.215453802,0.771054783,1359,-0.555600981
31145,638,4212,5061,0.126062043,0.832246592,3574,-0.706184549,NE,Red Willow County,,4868,940,3855,0.193097781,0.791906327,2915,-0.598808546
31147,798,2684,3666,0.217675941,0.732133115,1886,-0.514457174,NE,Richardson County,,3680,1180,2407,0.320652174,0.654076087,1227,-0.333423913
31149,70,687,793,0.088272383,0.866330391,617,-0.778058008,NE,Rock County,,784,103,669,0.131377551,0.853316327,566,-0.721938776
31151,1630,2849,4795,0.339937435,0.594160584,1219,-0.254223149,NE,Saline County,,4832,2232,2518,0.46192053,0.521109272,286,-0.059188742
31153,27704,44649,77781,0.35617953,0.57403479,16945,-0.21785526,NE,Sarpy County,,66166,24709,40318,0.373439531,0.60934619,15609,-0.235906659
31155,2509,7486,10598,0.236742782,0.706359691,4977,-0.469616909,NE,Saunders County,,10203,3279,6725,0.321376066,0.659119867,3446,-0.337743801
31157,3151,9952,13895,0.22677222,0.716228859,6801,-0.489456639,NE,Scotts Bluff County,,13867,4193,9427,0.302372539,0.679815389,5234,-0.37744285
31159,1881,5451,7754,0.242584473,0.702992004,3570,-0.460407532,NE,Seward County,,7445,2362,4947,0.317259906,0.664472801,2585,-0.347212895
31161,286,2192,2565,0.111500975,0.854580897,1906,-0.743079922,NE,Sheridan County,,2450,389,2010,0.15877551,0.820408163,1621,-0.661632653
31163,338,1143,1553,0.217643271,0.735994849,805,-0.518351578,NE,Sherman County,,1508,549,919,0.364058355,0.609416446,370,-0.24535809
31165,77,602,709,0.108603667,0.849083216,525,-0.740479549,NE,Sioux County,,735,101,623,0.137414966,0.847619048,522,-0.710204082
31167,417,2173,2748,0.151746725,0.790756914,1756,-0.639010189,NE,Stanton County,,2623,607,1945,0.231414411,0.741517347,1338,-0.510102936
31169,490,1993,2613,0.187523919,0.762724837,1503,-0.575200918,NE,Thayer County,,2627,724,1853,0.275599543,0.705367339,1129,-0.429767796
31171,30,344,387,0.07751938,0.888888889,314,-0.811369509,NE,Thomas County,,408,42,360,0.102941176,0.882352941,318,-0.779411765
31173,911,1013,2029,0.44898965,0.49926072,102,-0.050271069,NE,Thurston County,,1993,1153,823,0.578524837,0.412945309,330,0.165579528
31175,337,1770,2172,0.155156538,0.814917127,1433,-0.659760589,NE,Valley County,,2168,494,1643,0.227859779,0.757841328,1149,-0.52998155
31177,2606,7374,10584,0.246220711,0.696712018,4768,-0.450491308,NE,Washington County,,10121,3103,6857,0.306590258,0.677502223,3754,-0.370911965
31179,828,2675,3740,0.221390374,0.715240642,1847,-0.493850267,NE,Wayne County,,3659,1074,2493,0.29352282,0.681333698,1419,-0.387810877
31181,306,1320,1687,0.181387078,0.78245406,1014,-0.601066983,NE,Webster County,,1730,440,1255,0.25433526,0.725433526,815,-0.471098266
31183,62,377,459,0.135076253,0.821350763,315,-0.68627451,NE,Wheeler County,,446,93,345,0.208520179,0.773542601,252,-0.565022422
31185,1181,4686,6256,0.188778772,0.749040921,3505,-0.560262148,NE,York County,,6246,1352,4814,0.216458533,0.770733269,3462,-0.554274736
32001,2210,7828,10936,0.202084857,0.715801024,5618,-0.513716167,NV,Churchill County,,10265,2961,7061,0.288455918,0.687871408,4100,-0.39941549
32003,401068,319571,765421,0.523983533,0.417510102,81497,0.106473431,NV,Clark County,,688339,387978,288223,0.563643786,0.418722461,99755,0.144921325
32005,8453,17406,27871,0.303290158,0.624520111,8953,-0.321229952,NV,Douglas County,,26054,9288,16264,0.356490366,0.624241959,6976,-0.267751593
32007,3400,13542,18545,0.183337827,0.73022378,10142,-0.546885953,NV,Elko County,,15984,3510,12013,0.219594595,0.751564064,8503,-0.531969469
32009,65,329,423,0.153664303,0.777777778,264,-0.624113475,NV,Esmeralda County,,435,92,317,0.211494253,0.728735632,225,-0.517241379
32011,74,723,854,0.086651054,0.846604215,649,-0.759953162,NV,Eureka County,,808,107,663,0.132425743,0.820544554,556,-0.688118812
32013,1386,4521,6433,0.215451578,0.702782528,3135,-0.48733095,NV,Humboldt County,,5744,1737,3810,0.302402507,0.663300836,2073,-0.360898329
32015,403,1828,2413,0.167012018,0.757563199,1425,-0.590551181,NV,Lander County,,2165,534,1580,0.24665127,0.729792148,1046,-0.483140878
32017,285,1671,2132,0.133677298,0.783771107,1386,-0.650093809,NV,Lincoln County,,2152,400,1691,0.185873606,0.785780669,1291,-0.599907063
32019,6146,16005,23762,0.258648262,0.673554415,9859,-0.414906153,NV,Lyon County,,21465,7380,13520,0.343815514,0.629862567,6140,-0.286047053
32021,637,1179,1997,0.318978468,0.590385578,542,-0.271407111,NV,Mineral County,,2035,863,1080,0.424078624,0.530712531,217,-0.106633907
32023,5095,13320,19592,0.260055125,0.679869334,8225,-0.41981421,NV,Nye County,,17522,6320,10566,0.360689419,0.603013355,4246,-0.242323936
32027,430,1403,1982,0.216952573,0.707870838,973,-0.490918264,NV,Pershing County,,1884,632,1167,0.335456476,0.619426752,535,-0.283970276
32029,752,1616,2558,0.293979672,0.63174355,864,-0.337763878,NV,Storey County,,2314,920,1321,0.397579948,0.570872947,401,-0.173292999
32031,97032,94529,209282,0.463642358,0.451682419,2503,0.011959939,NV,Washoe County,,186917,94806,88151,0.507209082,0.471605044,6655,0.035604038
32033,707,2723,3773,0.187384045,0.721706865,2016,-0.53432282,NV,White Pine County,,3704,983,2601,0.265388769,0.702213823,1618,-0.436825054
32510,9610,13125,25016,0.384154141,0.524664215,3515,-0.140510074,NV,Carson City,,23318,10290,12394,0.441289991,0.531520714,2104,-0.090230723
33001,13517,19315,34462,0.392229122,0.560472404,5798,-0.168243282,NH,Belknap County,,33771,15884,17568,0.470344378,0.520209647,1684,-0.049865269
33003,12987,14635,29063,0.446856828,0.503561229,1648,-0.056704401,NH,Carroll County,,28464,13977,14207,0.491041315,0.499121698,230,-0.008080382
33005,22064,16876,41080,0.537098345,0.410808179,5188,0.126290166,NH,Cheshire County,,41071,25329,15135,0.616712522,0.368508193,10194,0.248204329
33007,6558,7951,15255,0.429891839,0.521206162,1393,-0.091314323,NH,Coos County,,15614,9091,6342,0.582233893,0.406173946,2749,0.176059946
33009,28510,19010,50065,0.569459702,0.379706382,9500,0.189753321,NH,Grafton County,,48765,29826,18207,0.611627192,0.373362042,11619,0.238265149
33011,99589,100013,210622,0.472832847,0.474845933,424,-0.002013085,NH,Hillsborough County,,202765,101499,98103,0.500574557,0.483826104,3396,0.016748453
33013,40198,37674,81982,0.490327145,0.459539899,2524,0.030787246,NH,Merrimack County,,80054,44635,34451,0.557561146,0.430347016,10184,0.12721413
33015,79994,90447,179005,0.446881372,0.505276389,10453,-0.058395017,NH,Rockingham County,,169794,80096,87809,0.47172456,0.517150194,7713,-0.045425633
33017,34894,29072,67918,0.513766601,0.428045584,5822,0.085721017,NH,Strafford County,,63762,36026,26779,0.565007371,0.419983689,9247,0.145023682
33019,10210,10796,22101,0.461970047,0.488484684,586,-0.026514637,NH,Sullivan County,,21814,12166,9269,0.557715229,0.424910608,2897,0.132804621
34001,54472,47882,105738,0.515160113,0.452836256,6590,0.062323857,NJ,Atlantic County,,102405,59509,41918,0.581114203,0.409335482,17591,0.171778722
34003,209251,163220,383965,0.544974151,0.425090829,46031,0.119883323,NJ,Bergen County,,352023,193470,155267,0.549594771,0.441070612,38203,0.108524159
34005,108361,79539,194988,0.555731635,0.40791741,28822,0.147814224,NJ,Burlington County,,197059,115951,79110,0.588407533,0.401453372,36841,0.186954161
34007,142375,71020,220437,0.645876146,0.322178219,71355,0.323697927,NJ,Camden County,,203201,137795,63329,0.678121663,0.311656931,74466,0.366464732
34009,18626,28237,48375,0.385033592,0.583710594,9611,-0.198677003,NJ,Cape May County,,47243,21275,25488,0.450331266,0.539508499,4213,-0.089177233
34011,27045,24213,53018,0.510109774,0.456693953,2832,0.053415821,NJ,Cumberland County,,49472,30172,18767,0.609880336,0.379345893,11405,0.230534444
34013,231031,62059,299808,0.770596515,0.206995811,168972,0.563600704,NJ,Essex County,,281633,217950,61595,0.773879481,0.218706615,156355,0.555172867
34015,66355,66949,138388,0.479485215,0.483777495,594,-0.00429228,NJ,Gloucester County,,133568,72960,58915,0.54623862,0.441086188,14045,0.105152432
34017,149980,45615,201425,0.744594762,0.226461462,104365,0.5181333,NJ,Hudson County,,176104,136239,38082,0.773628083,0.216247218,98157,0.557380866
34019,28797,38565,70582,0.407993539,0.546385764,9768,-0.138392225,NJ,Hunterdon County,,62821,25148,36979,0.400311998,0.588640741,11831,-0.188328744
34021,93721,42604,141332,0.663126539,0.30144624,51117,0.361680299,NJ,Mercer County,,139064,94300,43155,0.678105045,0.310324743,51145,0.367780303
34023,164887,108981,282668,0.583323899,0.385544172,55906,0.197779727,NJ,Middlesex County,,285232,179515,102472,0.629364868,0.359258428,77043,0.27010644
34025,135825,165305,311474,0.436071711,0.530718455,29480,-0.094646744,NJ,Monmouth County,,268943,125471,140376,0.466533801,0.521954466,14905,-0.055420665
34027,114437,125376,248848,0.459867067,0.503825628,10939,-0.043958561,NJ,Morris County,,206580,90313,114265,0.437181721,0.553127118,23952,-0.115945396
34029,81845,170103,259592,0.315283214,0.655270578,88258,-0.339987365,NJ,Ocean County,,237432,96500,138594,0.406432157,0.583720813,42094,-0.177288655
34031,112608,71488,189099,0.595497596,0.378045362,41120,0.217452234,NJ,Passaic County,,164629,104057,59181,0.632069684,0.359481015,44876,0.272588669
34033,11766,16256,29220,0.402669405,0.55633128,4490,-0.153661875,NJ,Salem County,,29116,14456,14214,0.496496772,0.48818519,242,0.008311581
34035,83839,64640,154249,0.543530266,0.419062684,19199,0.124467582,NJ,Somerset County,,134932,70168,63159,0.520024901,0.468080218,7009,0.051944683
34037,24132,46486,73860,0.326726239,0.629379908,22354,-0.302653669,NJ,Sussex County,,61704,23406,37215,0.37932711,0.603121354,13809,-0.223794243
34039,145412,67582,219385,0.66281651,0.308052055,77830,0.354764455,NJ,Union County,,202353,134220,66457,0.663296319,0.328421125,67763,0.334875193
34041,16991,29393,48442,0.35074935,0.606766855,12402,-0.256017505,NJ,Warren County,,43312,17869,24695,0.412564647,0.570165312,6826,-0.157600665
35001,141960,93874,269861,0.526048595,0.347860565,48086,0.17818803,NM,Bernalillo County,,264942,147183,104242,0.555529135,0.393452152,42941,0.162076983
35003,426,1453,2024,0.210474308,0.717885375,1027,-0.507411067,NM,Catron County,,2100,557,1474,0.265238095,0.701904762,917,-0.436666667
35005,5530,12869,20159,0.274319163,0.638374919,7339,-0.364055757,NM,Chaves County,,20498,6621,13271,0.323007123,0.647429017,6650,-0.324421895
35006,3721,3179,7975,0.466583072,0.39862069,542,0.067962382,NM,Cibola County,,8154,4907,2966,0.601790532,0.363747854,1941,0.238042678
35007,2118,2569,5271,0.401821286,0.487383798,451,-0.085562512,NM,Colfax County,,5896,2879,2763,0.488297151,0.468622795,116,0.019674355
35009,2776,7560,11292,0.245837761,0.669500531,4784,-0.42366277,NM,Curry County,,13450,3956,9150,0.294126394,0.680297398,5194,-0.386171004
35011,192,617,903,0.212624585,0.683277962,425,-0.470653378,NM,De Baca County,,900,287,586,0.318888889,0.651111111,299,-0.332222222
35013,37543,25095,69324,0.541558479,0.361995846,12448,0.179562633,NM,Dona Ana County,,65712,36778,26988,0.559684685,0.410701242,9790,0.148983443
35015,5008,13124,19523,0.256517953,0.672232751,8116,-0.415714798,NM,Eddy County,,19195,6110,12546,0.31831206,0.65360771,6436,-0.33529565
35017,6226,5251,12633,0.492836223,0.415657405,975,0.077178817,NM,Grant County,,12744,7009,5286,0.549984306,0.414783427,1723,0.135200879
35019,962,591,1809,0.531785517,0.326699834,371,0.205085683,NM,Guadalupe County,,1978,1388,518,0.701718908,0.261880688,870,0.43983822
35021,156,311,527,0.29601518,0.590132827,155,-0.294117647,NM,Harding County,,600,260,326,0.433333333,0.543333333,66,-0.11
35023,780,906,1836,0.424836601,0.493464052,126,-0.068627451,NM,Hidalgo County,,1929,994,895,0.515292898,0.463970969,99,0.051321928
35025,3877,12306,17369,0.223213772,0.708503656,8429,-0.485289884,NM,Lea County,,16933,4068,12480,0.24024095,0.737022382,8412,-0.496781433
35027,2329,5889,8856,0.262985547,0.6649729,3560,-0.401987353,NM,Lincoln County,,9209,2931,5940,0.3182756,0.645021175,3009,-0.326745575
35028,5443,3329,10430,0.521860019,0.319175455,2114,0.202684564,NM,Los Alamos County,,10654,5191,4796,0.487234841,0.450159564,395,0.037075277
35029,3195,3478,7245,0.440993789,0.48005521,283,-0.039061422,NM,Luna County,,7472,3573,3654,0.478185225,0.489025696,81,-0.010840471
35031,13162,4893,20791,0.633062383,0.235342215,8269,0.397720167,NM,McKinley County,,21313,15363,5420,0.720827664,0.254304884,9943,0.46652278
35033,1533,662,2429,0.631123919,0.27254014,871,0.358583779,NM,Mora County,,2604,1952,591,0.749615975,0.226958525,1361,0.52265745
35035,6033,11756,19636,0.307241801,0.598696272,5723,-0.291454471,NM,Otero County,,19643,6715,12219,0.341852059,0.622053658,5504,-0.280201599
35037,1016,2208,3550,0.286197183,0.621971831,1192,-0.335774648,NM,Quay County,,3696,1382,2194,0.373917749,0.593614719,812,-0.21969697
35039,9534,3583,14767,0.645628767,0.242635606,5951,0.40299316,NM,Rio Arriba County,,15239,11389,3373,0.747358751,0.221339983,8016,0.526018768
35041,1445,3865,5855,0.246797609,0.660119556,2420,-0.413321947,NM,Roosevelt County,,5949,1719,4032,0.288956127,0.677760968,2313,-0.388804841
35043,27405,25748,60597,0.452250111,0.424905523,1657,0.027344588,NM,Sandoval County,,53361,26831,24124,0.502820412,0.452090478,2707,0.050729934
35045,12826,27879,45476,0.282038878,0.613048641,15053,-0.331009763,NM,San Juan County,,45994,15688,28779,0.341087968,0.625712049,13091,-0.284624081
35047,7249,2302,10662,0.679891202,0.215906959,4947,0.463984243,NM,San Miguel County,,11388,8754,2281,0.768703899,0.20029856,6473,0.568405339
35049,49956,14198,70082,0.712822123,0.20259125,35758,0.510230872,NM,Santa Fe County,,67624,49668,15145,0.734472968,0.223958949,34523,0.510514019
35051,1600,2998,5129,0.311951647,0.584519399,1398,-0.272567752,NM,Sierra County,,5101,1963,2928,0.384826505,0.574005097,965,-0.189178592
35053,3275,2592,6756,0.484754292,0.38365897,683,0.101095323,NM,Socorro County,,7087,3983,2698,0.562014957,0.380697051,1285,0.181317906
35055,10550,2706,15072,0.699973461,0.179538217,7844,0.520435244,NM,Taos County,,15188,11855,2710,0.780550435,0.17843034,9145,0.602120095
35057,1770,3695,6250,0.2832,0.5912,1925,-0.308,NM,Torrance County,,6376,2414,3521,0.378607277,0.552227102,1107,-0.173619824
35059,318,1214,1688,0.188388626,0.719194313,896,-0.530805687,NM,Union County,,1753,471,1231,0.268682259,0.702224758,760,-0.433542499
35061,10810,13175,27350,0.395246801,0.481718464,2365,-0.086471664,NM,Valencia County,,27647,13473,12788,0.487322313,0.462545665,685,0.024776648
36001,74775,44227,125644,0.59513387,0.352002483,30548,0.243131387,NY,Albany County,,125531,80891,42029,0.644390629,0.334809728,38862,0.3095809
36003,4473,11712,17111,0.261410788,0.684471977,7239,-0.423061189,NY,Allegany County,,15601,5658,9609,0.36266906,0.615922056,3951,-0.253252997
36005,318403,34424,358857,0.88726986,0.09592679,283979,0.79134307,NY,Bronx County,,316047,288378,26304,0.912452895,0.083228127,262074,0.829224767
36007,35212,38077,77657,0.453429826,0.49032283,2865,-0.036893004,NY,Broome County,,75244,38315,34878,0.509210037,0.463531976,3437,0.045678061
36009,8717,18668,28961,0.300990988,0.644591002,9951,-0.343600014,NY,Cattaraugus County,,27608,11695,15406,0.423609099,0.558026659,3711,-0.13441756
36011,12202,16194,30124,0.405059089,0.537578011,3992,-0.132518922,NY,Cayuga County,,26073,14162,11355,0.543167261,0.435507997,2807,0.107659264
36013,17281,29418,49381,0.349952411,0.595735202,12137,-0.245782791,NY,Chautauqua County,,48434,21815,25795,0.450406739,0.532580419,3980,-0.08217368
36015,12394,19025,33195,0.373369483,0.573128483,6631,-0.199759,NY,Chemung County,,31981,15285,16207,0.477940027,0.506769644,922,-0.028829618
36017,5943,11024,18113,0.328106885,0.60862364,5081,-0.280516756,NY,Chenango County,,17655,8340,8933,0.472387426,0.505975644,593,-0.033588219
36019,13446,13181,28378,0.473817746,0.464479526,265,0.00933822,NY,Clinton County,,27622,17123,10054,0.619904424,0.363985229,7069,0.255919195
36021,13123,12756,27255,0.481489635,0.468024216,367,0.013465419,NY,Columbia County,,26008,14244,11194,0.547677638,0.430406029,3050,0.117271609
36023,7976,9207,18424,0.432913591,0.499728615,1231,-0.066815024,NY,Cortland County,,17698,9445,7886,0.533676122,0.445587072,1559,0.08808905
36025,5825,11012,17778,0.327652154,0.619417257,5187,-0.291765103,NY,Delaware County,,16916,7469,9085,0.441534642,0.5370655,1616,-0.095530858
36027,56874,58163,120199,0.473165334,0.483889217,1289,-0.010723883,NY,Dutchess County,,114142,59885,52320,0.524653502,0.458376408,7565,0.066277093
36029,192065,173817,383248,0.501150691,0.453536613,18248,0.047614078,NY,Erie County,,386665,220184,159678,0.569443834,0.412962125,60506,0.156481709
36031,6760,7275,15079,0.448305591,0.482459049,515,-0.034153458,NY,Essex County,,15577,8835,6495,0.567182384,0.416960904,2340,0.15022148
36033,6517,7636,15148,0.430221811,0.50409295,1119,-0.073871138,NY,Franklin County,,14537,9065,5248,0.623581207,0.361009837,3817,0.26257137
36035,5805,12759,19563,0.29673363,0.652200583,6954,-0.355466953,NY,Fulton County,,18040,7916,9811,0.438802661,0.543847007,1895,-0.105044346
36037,6946,15986,24463,0.28393901,0.653476679,9040,-0.369537669,NY,Genesee County,,23079,8886,13701,0.385025348,0.593656571,4815,-0.208631223
36039,6370,11546,18869,0.337590757,0.611903122,5176,-0.274312364,NY,Greene County,,18263,7911,9935,0.433170892,0.543996058,2024,-0.110825166
36041,752,1795,2688,0.279761905,0.667782738,1043,-0.388020833,NY,Hamilton County,,2655,955,1652,0.359698682,0.622222222,697,-0.26252354
36043,7289,15664,24261,0.300441037,0.645645274,8375,-0.345204237,NY,Herkimer County,,23290,10433,12389,0.447960498,0.531945041,1956,-0.083984543
36045,12289,19947,34263,0.358666783,0.58217319,7658,-0.223506406,NY,Jefferson County,,32051,15345,16279,0.478768213,0.50790927,934,-0.029141056
36047,595086,133653,746295,0.797387092,0.179088698,461433,0.618298394,NY,Kings County,,618035,503291,108630,0.814340612,0.175766745,394661,0.638573867
36049,2828,6916,10312,0.2742436,0.670674942,4088,-0.396431342,NY,Lewis County,,9481,4263,5083,0.449636114,0.536124881,820,-0.086488767
36051,10478,19211,31363,0.334087938,0.612537066,8733,-0.278449128,NY,Livingston County,,24606,10889,13210,0.442534341,0.536860928,2321,-0.094326587
36053,10548,14901,27392,0.385075935,0.543990946,4353,-0.158915012,NY,Madison County,,25865,12698,12611,0.490933694,0.487570075,87,0.003363619
36055,174063,128871,320164,0.543668245,0.402515586,45192,0.141152659,NY,Monroe County,,308925,178491,124769,0.577781015,0.403881201,53722,0.173899814
36057,5961,10579,17438,0.341839661,0.606663608,4618,-0.264823948,NY,Montgomery County,,16784,7881,8622,0.469554337,0.513703527,741,-0.04414919
36059,307326,275479,599649,0.512509818,0.459400416,31847,0.053109402,NY,Nassau County,,460824,243649,212882,0.528724632,0.461959447,30767,0.066765186
36061,515481,58935,591368,0.871675505,0.099658757,456546,0.772016748,NY,New York County,,496293,417861,72300,0.841964323,0.145680072,345561,0.696284251
36063,32888,49223,86000,0.382418605,0.572360465,16335,-0.18994186,NY,Niagara County,,82720,40862,40397,0.493979691,0.488358317,465,0.005621373
36065,30749,48490,83876,0.366600696,0.578115313,17741,-0.211514617,NY,Oneida County,,80429,37388,41639,0.464857203,0.517711273,4251,-0.05285407
36067,102915,78277,191962,0.536121732,0.407773413,24638,0.128348319,NY,Onondaga County,,188787,112664,72807,0.59677838,0.385656851,39857,0.211121528
36069,20233,24343,47664,0.424492279,0.510720879,4110,-0.0862286,NY,Ontario County,,44144,21285,21998,0.482171983,0.498323668,713,-0.016151685
36071,63037,72129,140753,0.447855463,0.512450889,9092,-0.064595426,NY,Orange County,,130494,67709,60984,0.518866768,0.467331831,6725,0.051534936
36073,4327,11582,16722,0.258760914,0.6926205,7255,-0.433859586,NY,Orleans County,,13756,5411,8076,0.393355627,0.58708927,2665,-0.193733644
36075,15614,25870,44122,0.353882417,0.586328816,10256,-0.232446399,NY,Oswego County,,41133,21733,18503,0.528359225,0.449833467,3230,0.078525758
36077,9285,12284,23024,0.403274844,0.533530229,2999,-0.130255386,NY,Otsego County,,21938,10975,10527,0.500273498,0.479852311,448,0.020421187
36079,17363,25241,44186,0.392952519,0.571244286,7878,-0.178291767,NY,Putnam County,,40883,17851,22436,0.436636255,0.548785559,4585,-0.112149304
36081,473389,138550,627021,0.754981093,0.220965486,334839,0.534015607,NY,Queens County,,507722,399970,103193,0.787773624,0.203247053,296777,0.584526572
36083,30039,31933,65991,0.455198436,0.48389932,1894,-0.028700883,NY,Rensselaer County,,63332,34713,27240,0.548111539,0.430114318,7473,0.117997221
36085,67561,95612,167209,0.404051217,0.571811326,28051,-0.167760109,NY,Richmond County,,135283,67524,66420,0.49913145,0.49097078,1104,0.008160671
36087,63454,57148,123943,0.511961143,0.461082917,6306,0.050878226,NY,Rockland County,,114500,60446,52936,0.527912664,0.462323144,7510,0.06558952
36089,14659,18450,35154,0.416993799,0.524833589,3791,-0.107839791,NY,St. Lawrence County,,34023,19574,13914,0.575316698,0.408958646,5660,0.166358052
36091,46546,51088,104089,0.447175014,0.490810748,4542,-0.043635735,NY,Saratoga County,,97502,48876,46829,0.501282025,0.480287584,2047,0.020994441
36093,30870,27268,61629,0.50090055,0.442454039,3602,0.058446511,NY,Schenectady County,,59614,33777,24608,0.566595095,0.412788942,9169,0.153806153
36095,3777,8173,12673,0.298035193,0.644914385,4396,-0.346879192,NY,Schoharie County,,11943,4862,6849,0.407100394,0.573474002,1987,-0.166373608
36097,2761,5179,8423,0.327792948,0.614864063,2418,-0.287071115,NY,Schuyler County,,7464,3354,3942,0.449356913,0.528135048,588,-0.078778135
36099,5175,6719,12727,0.406615856,0.527932741,1544,-0.121316885,NY,Seneca County,,12148,6526,5405,0.537207771,0.444929206,1121,0.092278564
36101,11215,25091,38373,0.292262789,0.653871212,13876,-0.361608423,NY,Steuben County,,35659,14586,20425,0.409041196,0.572786674,5839,-0.163745478
36103,276953,328403,625720,0.442614908,0.524840184,51450,-0.082225276,NY,Suffolk County,,540653,274830,259348,0.508329742,0.479694,15482,0.028635742
36105,10983,14626,26509,0.41431212,0.551737146,3643,-0.137425025,NY,Sullivan County,,25322,13781,11148,0.544230314,0.440249585,2633,0.103980728
36107,6852,12528,20556,0.333333333,0.609457093,5676,-0.276123759,NY,Tioga County,,19977,8263,11278,0.41362567,0.564549232,3015,-0.150923562
36109,25555,9647,37747,0.677007444,0.255569979,15908,0.421437465,NY,Tompkins County,,35825,24447,10202,0.682400558,0.284773203,14245,0.397627355
36111,40010,32962,77134,0.518707703,0.427334249,7048,0.091373454,NY,Ulster County,,72193,43164,27340,0.597897303,0.378707077,15824,0.219190226
36113,11366,14284,27568,0.412289611,0.51813697,2918,-0.105847359,NY,Warren County,,26220,13112,12571,0.500076278,0.479443173,541,0.020633105
36115,8238,12770,22401,0.36775144,0.570063836,4532,-0.202312397,NY,Washington County,,21263,10596,10254,0.498330433,0.482246155,342,0.016084278
36117,12378,21935,36598,0.338215203,0.599349691,9557,-0.261134488,NY,Wayne County,,34127,15136,18315,0.443519794,0.536671843,3179,-0.09315205
36119,245670,121643,378506,0.649051798,0.321376676,124027,0.327675123,NY,Westchester County,,284731,171908,108707,0.603755826,0.381788425,63201,0.221967401
36121,3585,11884,16280,0.220208845,0.72997543,8299,-0.509766585,NY,Wyoming County,,15230,5224,9726,0.343007223,0.638608011,4502,-0.295600788
36123,3219,5180,8975,0.358662953,0.577158774,1961,-0.218495822,NY,Yates County,,8437,4021,4270,0.476591205,0.506104065,249,-0.02951286
37001,29268,38235,69264,0.422557173,0.552018365,8967,-0.129461192,NC,Alamance County,,66638,28341,37712,0.425297878,0.565923347,9371,-0.140625469
37003,3750,13826,18011,0.208206096,0.767641997,10076,-0.5594359,NC,Alexander County,,17060,4591,12207,0.269109027,0.715533411,7616,-0.446424385
37005,1300,3789,5214,0.24932873,0.726697353,2489,-0.477368623,NC,Alleghany County,,5025,1574,3378,0.313233831,0.672238806,1804,-0.359004975
37007,5785,4480,10394,0.556571099,0.431017895,1305,0.125553204,NC,Anson County,,11072,6894,4125,0.622651734,0.372561416,2769,0.250090318
37009,3476,9353,13160,0.264133739,0.710714286,5877,-0.446580547,NC,Ashe County,,12486,4100,8207,0.328367772,0.657296172,4107,-0.3289284
37011,1670,6226,8060,0.20719603,0.772456576,4556,-0.565260546,NC,Avery County,,7657,1861,5708,0.243045579,0.745461669,3847,-0.50241609
37013,8699,14478,23599,0.368617314,0.613500572,5779,-0.244883258,NC,Beaufort County,,23468,9399,13918,0.400502812,0.593062894,4519,-0.192560082
37015,5837,3476,9380,0.62228145,0.370575693,2361,0.251705757,NC,Bertie County,,9941,6537,3367,0.65757972,0.33869832,3170,0.3188814
37017,7021,8511,15743,0.445975989,0.540621228,1490,-0.094645239,NC,Bladen County,,16351,8277,7947,0.506207571,0.48602532,330,0.020182252
37019,23117,42440,67255,0.343721656,0.63103115,19323,-0.287309494,NC,Brunswick County,,56985,21932,34587,0.384873212,0.606949197,12655,-0.222075985
37021,74937,55339,134507,0.557123421,0.411420967,19598,0.145702454,NC,Buncombe County,,126201,70066,54429,0.555193699,0.431288183,15637,0.123905516
37023,10930,25741,37638,0.290398002,0.683909878,14811,-0.393511876,NC,Burke County,,36116,13577,22109,0.375927567,0.612166353,8532,-0.236238786
37025,35048,53224,91002,0.385134393,0.584866267,18176,-0.199731874,NC,Cabarrus County,,82445,32453,49125,0.393632118,0.59585178,16672,-0.202219662
37027,8403,26499,35747,0.235068677,0.741292976,18096,-0.506224299,NC,Caldwell County,,34338,10795,23069,0.314374745,0.671821306,12274,-0.357446561
37029,1266,3527,4939,0.256327192,0.714112168,2261,-0.457784977,NC,Camden County,,4520,1456,2995,0.322123894,0.662610619,1539,-0.340486726
37031,9806,26228,36919,0.265608494,0.710420109,16422,-0.444811615,NC,Carteret County,,35124,10197,24598,0.290314315,0.70031887,14401,-0.410004555
37033,4549,5758,10515,0.432620067,0.547598669,1209,-0.114978602,NC,Caswell County,,10736,5183,5471,0.482768256,0.50959389,288,-0.026825633
37035,21050,48062,71065,0.296207697,0.67631042,27012,-0.380102723,NC,Catawba County,,69102,23954,44386,0.346646986,0.642325837,20432,-0.295678852
37037,20953,17012,39080,0.536156602,0.43531218,3941,0.100844422,NC,Chatham County,,35157,18252,16578,0.519156925,0.47154194,1674,0.047614984
37039,2809,10711,13860,0.202669553,0.772799423,7902,-0.57012987,NC,Cherokee County,,12695,3339,9201,0.263016936,0.724773533,5862,-0.461756597
37041,2965,3983,7108,0.417135622,0.56035453,1018,-0.143218908,NC,Chowan County,,7424,3507,3872,0.472386853,0.521551724,365,-0.049164871
37043,1352,4395,5885,0.229736619,0.746813934,3043,-0.517077315,NC,Clay County,,5592,1573,3952,0.281294707,0.706723891,2379,-0.425429185
37045,14896,28394,44137,0.337494619,0.643315132,13498,-0.305820513,NC,Cleveland County,,42542,16734,25440,0.393352452,0.597997273,8706,-0.204644822
37047,8991,14177,23472,0.383052147,0.603996251,5186,-0.220944104,NC,Columbus County,,24017,10973,12863,0.456884707,0.535578965,1890,-0.078694258
37049,17481,27556,46231,0.378122905,0.596050269,10075,-0.217927365,NC,Craven County,,45585,18556,26654,0.407063727,0.584709883,8098,-0.177646156
37051,70523,50593,124402,0.566896031,0.406689603,19930,0.160206428,NC,Cumberland County,,126092,74991,50191,0.594732418,0.39805063,24800,0.196681788
37053,2879,9070,12423,0.231747565,0.7300974,6191,-0.498349835,NC,Currituck County,,11153,3521,7431,0.315699812,0.666278131,3910,-0.35057832
37055,7079,11283,19009,0.372402546,0.593560945,4204,-0.221158399,NC,Dare County,,17614,7258,10102,0.41205859,0.573521063,2844,-0.161462473
37057,17328,52870,72013,0.240623221,0.734172997,35542,-0.493549776,NC,Davidson County,,69994,20291,48935,0.289896277,0.699131354,28644,-0.409235077
37059,5228,15502,21350,0.244871194,0.726088993,10274,-0.481217799,NC,Davie County,,20418,5652,14568,0.276814575,0.713488099,8916,-0.436673523
37061,8196,12151,20601,0.397844765,0.589825737,3955,-0.191980972,NC,Duplin County,,20375,8923,11330,0.43793865,0.55607362,2407,-0.118134969
37063,118783,27879,150543,0.789030377,0.185189614,90904,0.603840763,NC,Durham County,,143828,109185,33326,0.759135912,0.231707317,75859,0.527428595
37065,16152,8219,24653,0.655173813,0.333387417,7933,0.321786395,NC,Edgecombe County,,26826,18249,8494,0.68027287,0.316633117,9755,0.363639752
37067,92488,74793,172509,0.536134347,0.433559988,17695,0.102574358,NC,Forsyth County,,172332,91606,79177,0.531566975,0.45944456,12429,0.072122415
37069,12811,16320,29902,0.428432881,0.545782891,3509,-0.11735001,NC,Franklin County,,28059,13317,14480,0.474607078,0.516055455,1163,-0.041448377
37071,30982,61467,94872,0.326566321,0.647894005,30485,-0.321327684,NC,Gaston County,,89638,32903,55817,0.367065307,0.622693501,22914,-0.255628193
37073,2371,2851,5328,0.445007508,0.535097598,480,-0.09009009,NC,Gates County,,5310,2745,2532,0.516949153,0.476836158,213,0.040112994
37075,761,3260,4094,0.185881778,0.79628725,2499,-0.610405471,NC,Graham County,,3910,1115,2743,0.28516624,0.701534527,1628,-0.416368286
37077,12827,13500,26920,0.476485884,0.501485884,673,-0.025,NC,Granville County,,26068,13529,12332,0.518988799,0.473070431,1197,0.045918367
37079,3570,4358,8013,0.44552602,0.543866217,788,-0.098340197,NC,Greene County,,8194,3761,4393,0.458994386,0.536123993,632,-0.077129607
37081,147949,97461,252087,0.586896587,0.386616525,50488,0.200280062,NC,Guilford County,,251529,145483,103964,0.578394539,0.413328085,41519,0.165066454
37083,15642,8954,24881,0.628672481,0.359872995,6688,0.268799486,NC,Halifax County,,25724,16931,8686,0.658179132,0.337661328,8245,0.320517804
37085,16452,27278,44955,0.365965966,0.606784562,10826,-0.240818596,NC,Harnett County,,42343,16858,25070,0.398129561,0.592069527,8212,-0.193939966
37087,10414,18844,30156,0.345337578,0.624883937,8430,-0.279546359,NC,Haywood County,,27679,11742,15553,0.424220528,0.561906138,3811,-0.13768561
37089,19664,35535,56810,0.346136244,0.625506073,15871,-0.279369829,NC,Henderson County,,51961,18519,32860,0.356401917,0.632397375,14341,-0.275995458
37091,6886,3081,10100,0.681782178,0.305049505,3805,0.376732673,NC,Hertford County,,10872,7815,3001,0.718818985,0.276030169,4814,0.442788815
37093,9608,7676,17847,0.538353785,0.430100297,1932,0.108253488,NC,Hoke County,,16800,9915,6721,0.590178571,0.400059524,3194,0.190119048
37095,956,1275,2273,0.420589529,0.560932688,319,-0.140343159,NC,Hyde County,,2358,1157,1183,0.490670059,0.501696353,26,-0.011026293
37097,24441,54164,80727,0.302761158,0.670952717,29723,-0.368191559,NC,Iredell County,,75762,25952,49071,0.342546395,0.647699374,23119,-0.305152979
37099,7564,9706,18004,0.42012886,0.539102422,2142,-0.118973561,NC,Jackson County,,16556,8052,8224,0.48634936,0.496738343,172,-0.010388983
37101,28153,54082,84553,0.332962757,0.639622485,25929,-0.306659728,NC,Johnston County,,76021,27052,48206,0.355849042,0.634114258,21154,-0.278265216
37103,2041,2941,5039,0.405040683,0.583647549,900,-0.178606866,NC,Jones County,,5192,2335,2825,0.449730354,0.544106317,490,-0.094375963
37105,10380,13625,24676,0.420651645,0.552155941,3245,-0.131504296,NC,Lee County,,23800,10577,13000,0.444411765,0.546218487,2423,-0.101806723
37107,11752,13354,25500,0.460862745,0.523686275,1602,-0.062823529,NC,Lenoir County,,27247,13350,13763,0.489962198,0.50511983,413,-0.015157632
37109,9836,28653,39449,0.249334584,0.726330198,18817,-0.476995615,NC,Lincoln County,,36532,10980,25184,0.300558415,0.689368225,14204,-0.388809811
37111,4645,14517,19557,0.237510866,0.742291763,9872,-0.504780897,NC,McDowell County,,17953,6006,11732,0.334540188,0.653484097,5726,-0.318943909
37113,4841,12035,17336,0.279245501,0.69422012,7194,-0.414974619,NC,Macon County,,16750,5692,10817,0.339820896,0.645791045,5125,-0.305970149
37115,3899,6735,10966,0.355553529,0.614171074,2836,-0.258617545,NC,Madison County,,10023,4466,5379,0.445575177,0.536665669,913,-0.091090492
37117,5814,5874,11852,0.490550118,0.495612555,60,-0.005062437,NC,Martin County,,12541,6514,5963,0.519416314,0.475480424,551,0.04393589
37119,292258,154303,461834,0.632820451,0.334109225,137955,0.298711225,NC,Mecklenburg County,,445062,270705,170490,0.608241099,0.383070224,100215,0.225170875
37121,1585,6225,7948,0.199421238,0.783215903,4640,-0.583794665,NC,Mitchell County,,7673,1810,5778,0.235892089,0.753030106,3968,-0.517138016
37123,4108,7070,11449,0.35880863,0.617521181,2962,-0.258712551,NC,Montgomery County,,11178,4689,6389,0.419484702,0.571569154,1700,-0.152084452
37125,16148,30273,47746,0.338206342,0.634042642,14125,-0.2958363,NC,Moore County,,46044,16371,29336,0.355551212,0.637129702,12965,-0.28157849
37127,23024,23142,46903,0.490885444,0.493401275,118,-0.002515831,NC,Nash County,,48235,24214,23769,0.502000622,0.492774956,445,0.009225666
37129,50219,54665,108737,0.461839116,0.502726763,4446,-0.040887646,NC,New Hanover County,,102067,48038,52792,0.470651631,0.517228879,4754,-0.046577248
37131,6113,3556,9761,0.6262678,0.364306936,2557,0.261960865,NC,Northampton County,,10719,7210,3474,0.672637373,0.324097397,3736,0.348539976
37133,17156,36342,55364,0.309876454,0.656419334,19186,-0.34654288,NC,Onslow County,,50353,18115,31695,0.359760094,0.62945604,13580,-0.269695947
37135,59105,18373,79830,0.74038582,0.230151572,40732,0.510234248,NC,Orange County,,75848,53404,21398,0.704092395,0.282116865,32006,0.42197553
37137,2427,4225,6772,0.358387478,0.623892499,1798,-0.265505021,NC,Pamlico County,,6712,2632,4032,0.392133492,0.600715137,1400,-0.208581645
37139,8455,8082,16964,0.498408394,0.476420656,373,0.021987739,NC,Pasquotank County,,17343,9970,7216,0.574871706,0.41607565,2754,0.158796056
37141,9086,17317,27072,0.335623522,0.639664598,8231,-0.304041076,NC,Pender County,,24036,9455,14368,0.393368281,0.597770012,4913,-0.204401731
37143,2291,4143,6595,0.347384382,0.628203184,1852,-0.280818802,NC,Perquimans County,,6621,2747,3814,0.41489201,0.576045915,1067,-0.161153904
37145,7772,11116,19303,0.402631715,0.575869036,3344,-0.173237321,NC,Person County,,19008,8384,10467,0.441077441,0.550662879,2083,-0.109585438
37147,40967,35191,78264,0.523446284,0.449644792,5776,0.073801492,NC,Pitt County,,76814,40701,35534,0.529864348,0.462597964,5167,0.067266384
37149,3715,6738,10723,0.346451553,0.628368927,3023,-0.281917374,NC,Polk County,,10323,4000,6219,0.387484258,0.602441151,2219,-0.214956892
37151,13074,49156,63615,0.205517567,0.772710839,36082,-0.567193272,NC,Randolph County,,60202,14675,44913,0.243762666,0.746038338,30238,-0.502275672
37153,8290,10199,18813,0.44065274,0.542125126,1909,-0.101472386,NC,Richmond County,,19127,9747,9236,0.509593768,0.482877608,511,0.02671616
37155,18377,20294,39454,0.465782937,0.514371166,1917,-0.048588229,NC,Robeson County,,41380,23957,17093,0.578951184,0.413073949,6864,0.165877235
37157,14057,26463,41374,0.339754435,0.639604583,12406,-0.299850147,NC,Rockingham County,,41549,16170,25037,0.389179042,0.602589713,8867,-0.213410672
37159,19208,42388,63078,0.304511874,0.671993405,23180,-0.367481531,NC,Rowan County,,61803,22529,38622,0.36452923,0.62492112,16093,-0.26039189
37161,7451,21694,29764,0.250335976,0.728867088,14243,-0.478531111,NC,Rutherford County,,28373,9277,18797,0.326965777,0.662496035,9520,-0.335530258
37163,10486,14761,25638,0.409002262,0.575746938,4275,-0.166744676,NC,Sampson County,,26005,11496,14358,0.442068833,0.552124591,2862,-0.110055759
37165,7279,6212,13743,0.529651459,0.452011933,1067,0.077639526,NC,Scotland County,,14020,8131,5799,0.579957204,0.413623395,2332,0.166333809
37167,7008,21788,29451,0.237954569,0.7398051,14780,-0.501850531,NC,Stanly County,,28276,8287,19698,0.2930754,0.696633187,11411,-0.403557788
37169,4645,16976,22182,0.209404021,0.765305202,12331,-0.555901181,NC,Stokes County,,21396,5969,15142,0.278977379,0.707702374,9173,-0.428724995
37171,7438,23495,31663,0.234911411,0.742033288,16057,-0.507121877,NC,Surry County,,29096,9005,19753,0.309492714,0.678890569,10748,-0.369397855
37173,2186,3557,5982,0.365429622,0.594617185,1371,-0.229187563,NC,Swain County,,5705,2618,2976,0.458895706,0.521647677,358,-0.062751972
37175,6520,10441,17440,0.373853211,0.598681193,3921,-0.224827982,NC,Transylvania County,,16469,6740,9522,0.409253749,0.578177181,2782,-0.168923432
37177,705,968,1700,0.414705882,0.569411765,263,-0.154705882,NC,Tyrrell County,,1775,835,929,0.470422535,0.523380282,94,-0.052957746
37179,34051,66265,103596,0.328690297,0.639648249,32214,-0.310957952,NC,Union County,,93389,32032,60468,0.342995428,0.64748525,28436,-0.304489822
37181,12168,7304,19762,0.615727153,0.369598219,4864,0.246128934,NC,Vance County,,20770,13286,7406,0.639672605,0.356571979,5880,0.283100626
37183,298353,193607,510940,0.58392962,0.378923161,104746,0.205006459,NC,Wake County,,526805,286939,232933,0.544677822,0.442161711,54006,0.102516111
37185,6668,3302,10123,0.658698014,0.326187889,3366,0.332510125,NC,Warren County,,9777,6635,3111,0.678633528,0.318195766,3524,0.360437762
37187,3490,2560,6115,0.570727719,0.418642682,930,0.152085037,NC,Washington County,,6456,3811,2615,0.590303594,0.405049566,1196,0.185254027
37189,13953,13521,28769,0.485001217,0.469985053,432,0.015016163,NC,Watauga County,,28168,13371,14124,0.474687589,0.501420051,753,-0.026732462
37191,21520,27360,49824,0.43192036,0.549132948,5840,-0.117212588,NC,Wayne County,,50988,23154,27536,0.454106849,0.540048639,4382,-0.08594179
37193,6596,23613,30844,0.213850344,0.765562184,17017,-0.55171184,NC,Wilkes County,,28852,8089,20410,0.280361847,0.7074033,12321,-0.427041453
37195,19527,17410,37593,0.519431809,0.463118134,2117,0.056313675,NC,Wilson County,,38890,20745,17904,0.533427616,0.460375418,2841,0.073052199
37197,3140,13815,17350,0.180979827,0.796253602,10675,-0.615273775,NC,Yadkin County,,16657,3928,12500,0.235816774,0.750435252,8572,-0.514618479
37199,3181,6367,9808,0.32432708,0.649163948,3186,-0.324836868,NC,Yancey County,,9344,3954,5249,0.423159247,0.561750856,1295,-0.13859161
38001,216,904,1206,0.179104478,0.749585406,688,-0.570480929,ND,Adams County,,1281,328,916,0.256049961,0.715066354,588,-0.459016393
38003,1597,3156,5253,0.304016752,0.600799543,1559,-0.296782791,ND,Barnes County,,5471,2389,2953,0.436666057,0.539755072,564,-0.103089015
38005,842,927,1940,0.434020619,0.477835052,85,-0.043814433,ND,Benson County,,2148,1232,867,0.573556797,0.403631285,365,0.169925512
38007,58,492,592,0.097972973,0.831081081,434,-0.733108108,ND,Billings County,,577,89,472,0.154246101,0.818024263,383,-0.663778163
38009,734,2482,3437,0.213558336,0.722141402,1748,-0.508583067,ND,Bottineau County,,3484,1163,2246,0.333811711,0.644661309,1083,-0.310849598
38011,227,1445,1769,0.128321085,0.816845676,1218,-0.68852459,ND,Bowman County,,1728,412,1277,0.238425926,0.73900463,865,-0.500578704
38013,118,879,1031,0.114451988,0.85257032,761,-0.738118332,ND,Burke County,,1015,230,766,0.226600985,0.754679803,536,-0.528078818
38015,10865,32499,46874,0.231791612,0.693326791,21634,-0.461535179,ND,Burleigh County,,42876,14036,27811,0.327362627,0.648637933,13775,-0.321275306
38017,31291,39738,78807,0.397058637,0.504244547,8447,-0.10718591,ND,Cass County,,73275,34632,36792,0.472630502,0.502108495,2160,-0.029477994
38019,476,1356,1969,0.24174708,0.688674454,880,-0.446927374,ND,Cavalier County,,2054,818,1192,0.398247322,0.580331061,374,-0.182083739
38021,551,1656,2372,0.232293423,0.698145025,1105,-0.465851602,ND,Dickey County,,2513,849,1601,0.337843215,0.637087147,752,-0.299243932
38023,243,860,1187,0.204717776,0.724515586,617,-0.51979781,ND,Divide County,,1151,382,731,0.331885317,0.635099913,349,-0.303214596
38025,356,1753,2199,0.161891769,0.797180537,1397,-0.635288768,ND,Dunn County,,2002,493,1494,0.246253746,0.746253746,1001,-0.5
38027,354,790,1219,0.290401969,0.64807219,436,-0.357670221,ND,Eddy County,,1147,484,631,0.421970357,0.550130776,147,-0.128160418
38029,215,1672,1959,0.109749872,0.853496682,1457,-0.74374681,ND,Emmons County,,1862,383,1430,0.205692803,0.767991407,1047,-0.562298604
38031,346,1237,1699,0.203649205,0.728075338,891,-0.524426133,ND,Foster County,,1674,604,1028,0.360812425,0.614097969,424,-0.253285544
38033,99,793,942,0.105095541,0.841825902,694,-0.736730361,ND,Golden Valley County,,924,161,740,0.174242424,0.800865801,579,-0.626623377
38035,10828,16325,29711,0.364444145,0.549459796,5497,-0.185015651,ND,Grand Forks County,,29796,14008,15044,0.470130219,0.504899987,1036,-0.034769768
38037,187,1098,1361,0.137398971,0.806759735,911,-0.669360764,ND,Grant County,,1383,331,1012,0.239334779,0.731742589,681,-0.492407809
38039,298,847,1247,0.238973536,0.679230152,549,-0.440256616,ND,Griggs County,,1335,535,770,0.400749064,0.576779026,235,-0.176029963
38041,168,1032,1261,0.133227597,0.818398097,864,-0.6851705,ND,Hettinger County,,1351,313,998,0.231680237,0.738712065,685,-0.507031828
38043,179,1106,1358,0.131811487,0.81443299,927,-0.682621502,ND,Kidder County,,1310,393,870,0.3,0.664122137,477,-0.364122137
38045,500,1475,2115,0.236406619,0.697399527,975,-0.460992908,ND,LaMoure County,,2179,737,1374,0.338228545,0.630564479,637,-0.292335934
38047,112,867,1030,0.108737864,0.841747573,755,-0.733009709,ND,Logan County,,1042,221,799,0.212092131,0.766794626,578,-0.554702495
38049,474,1991,2687,0.176404913,0.740975065,1517,-0.564570153,ND,McHenry County,,2653,924,1651,0.34828496,0.622314361,727,-0.274029401
38051,233,1095,1423,0.16373858,0.769501054,862,-0.605762474,ND,McIntosh County,,1510,456,1028,0.301986755,0.680794702,572,-0.378807947
38053,696,3661,4594,0.151501959,0.796909012,2965,-0.645407053,ND,McKenzie County,,3423,926,2450,0.270522933,0.715746421,1524,-0.445223488
38055,1070,3827,5206,0.205532078,0.735113331,2757,-0.529581252,ND,McLean County,,4894,1660,3130,0.339190846,0.639558643,1470,-0.300367797
38057,616,3715,4564,0.134969325,0.813978966,3099,-0.679009641,ND,Mercer County,,4394,1161,3132,0.264223942,0.712790168,1971,-0.448566227
38059,3077,11319,15547,0.197915997,0.728050428,8242,-0.530134431,ND,Morton County,,13510,4467,8669,0.330643967,0.641672835,4202,-0.311028868
38061,1211,2551,4009,0.302070342,0.636318284,1340,-0.334247942,ND,Mountrail County,,3444,1401,1960,0.406794425,0.569105691,559,-0.162311266
38063,536,1025,1694,0.316410862,0.605076741,489,-0.28866588,ND,Nelson County,,1668,766,862,0.459232614,0.516786571,96,-0.057553957
38065,119,827,1002,0.118762475,0.825349301,708,-0.706586826,ND,Oliver County,,1010,281,693,0.278217822,0.686138614,412,-0.407920792
38067,681,2204,3093,0.220174588,0.712576786,1523,-0.492402199,ND,Pembina County,,3226,1245,1893,0.385926844,0.586794792,648,-0.200867948
38069,431,1433,2020,0.213366337,0.709405941,1002,-0.496039604,ND,Pierce County,,2162,656,1462,0.303422757,0.676225717,806,-0.37280296
38071,1505,3216,5218,0.288424684,0.616328095,1711,-0.327903411,ND,Ramsey County,,4971,2162,2659,0.434922551,0.534902434,497,-0.099979883
38073,836,1209,2317,0.360811394,0.521795425,373,-0.160984031,ND,Ransom County,,2412,1341,1008,0.555970149,0.417910448,333,0.138059701
38075,200,978,1255,0.15936255,0.779282869,778,-0.619920319,ND,Renville County,,1272,398,850,0.312893082,0.668238994,452,-0.355345912
38077,2064,4759,7460,0.276675603,0.637935657,2695,-0.361260054,ND,Richland County,,7549,3190,4213,0.422572526,0.558087164,1023,-0.135514638
38079,2097,1210,3662,0.572637903,0.330420535,887,0.242217368,ND,Rolette County,,4528,3351,1090,0.740061837,0.240724382,2261,0.499337456
38081,693,1088,1978,0.350353893,0.550050556,395,-0.199696663,ND,Sargent County,,1987,1073,876,0.540010065,0.440865627,197,0.099144439
38083,94,644,774,0.121447028,0.832041344,550,-0.710594315,ND,Sheridan County,,808,161,637,0.199257426,0.788366337,476,-0.589108911
38085,758,256,1177,0.644010195,0.217502124,502,0.426508071,ND,Sioux County,,1138,900,223,0.79086116,0.195957821,677,0.594903339
38087,42,361,427,0.098360656,0.845433255,319,-0.7470726,ND,Slope County,,434,83,341,0.19124424,0.785714286,258,-0.594470046
38089,1745,9718,12115,0.144036319,0.8021461,7973,-0.658109781,ND,Stark County,,11539,2805,8509,0.243088656,0.737412254,5704,-0.494323598
38091,361,537,984,0.366869919,0.545731707,176,-0.178861789,ND,Steele County,,1028,515,495,0.500972763,0.48151751,20,0.019455253
38093,2484,6706,9938,0.249949688,0.674783659,4222,-0.424833971,ND,Stutsman County,,9431,3561,5641,0.377584562,0.598133814,2080,-0.220549252
38095,305,733,1137,0.26824978,0.64467898,428,-0.3764292,ND,Towner County,,1164,511,619,0.439003436,0.531786942,108,-0.092783505
38097,1239,2263,3864,0.320652174,0.585662526,1024,-0.265010352,ND,Traill County,,3841,1784,1963,0.46446238,0.511064827,179,-0.046602447
38099,1166,2991,4543,0.256658596,0.658375523,1825,-0.401716927,ND,Walsh County,,5061,2118,2809,0.418494369,0.55502865,691,-0.136534282
38101,5792,18601,26861,0.215628607,0.692490972,12809,-0.476862366,ND,Ward County,,25231,8412,16176,0.33339939,0.641116087,7764,-0.307716698
38103,419,1793,2352,0.178146259,0.762329932,1374,-0.584183673,ND,Wells County,,2359,671,1646,0.28444256,0.697753285,975,-0.413310725
38105,1722,10033,12529,0.137441137,0.800782185,8311,-0.663341049,ND,Williams County,,9600,2288,7087,0.238333333,0.738229167,4799,-0.499895833
39001,2293,8445,11063,0.207267468,0.763355329,6152,-0.55608786,OH,Adams County,,10787,3857,6691,0.357560026,0.620283675,2834,-0.262723649
39003,12815,29858,44636,0.287100099,0.668921946,17043,-0.381821848,OH,Allen County,,46458,16869,28802,0.363102157,0.619957811,11933,-0.256855655
39005,5659,17169,24074,0.235066877,0.713176041,11510,-0.478109163,OH,Ashland County,,23826,8083,15225,0.339251238,0.639007807,7142,-0.299756568
39007,15191,22755,39809,0.381597126,0.571604411,7564,-0.190007285,OH,Ashtabula County,,41781,22964,17890,0.549627821,0.42818506,5074,0.121442761
39009,15552,10816,27941,0.55660141,0.387101392,4736,0.169500018,OH,Athens County,,26112,17268,8118,0.661305147,0.310891544,9150,0.350413603
39011,3825,18130,22860,0.167322835,0.793088364,14305,-0.625765529,OH,Auglaize County,,22838,5643,16802,0.247088186,0.735703652,11159,-0.488615465
39013,8652,20729,30537,0.283328421,0.678815863,12077,-0.395487441,OH,Belmont County,,30876,13826,16418,0.447791165,0.531739863,2592,-0.083948698
39015,4270,14257,19139,0.223104655,0.744918752,9987,-0.521814097,OH,Brown County,,18955,6923,11671,0.365233448,0.615721446,4748,-0.250487998
39017,56700,104441,168422,0.336654356,0.620114949,47741,-0.283460593,OH,Butler County,,164020,59282,102226,0.361431533,0.623253262,42944,-0.261821729
39019,3124,9067,12807,0.243929101,0.707972203,5943,-0.464043101,OH,Carroll County,,12965,5396,7177,0.416197455,0.553567297,1781,-0.137369842
39021,4488,12314,17597,0.255043473,0.699778371,7826,-0.444734898,OH,Champaign County,,20016,7826,11852,0.39098721,0.592126299,4026,-0.201139089
39023,22666,34311,59620,0.380174438,0.5754948,11645,-0.195320362,OH,Clark County,,62136,30022,31116,0.483165959,0.500772499,1094,-0.01760654
39025,26096,65960,96455,0.270551034,0.683842206,39864,-0.413291172,OH,Clermont County,,93392,29334,62527,0.314095426,0.669511307,33193,-0.355415881
39027,3943,13466,18100,0.217845304,0.743977901,9523,-0.526132597,OH,Clinton County,,17648,5534,11740,0.313576609,0.665231188,6206,-0.351654578
39029,12273,31086,45261,0.271160602,0.686816465,18813,-0.415655863,OH,Columbiana County,,45078,19351,24778,0.42927814,0.549669462,5427,-0.120391322
39031,3908,10381,14961,0.261212486,0.693870731,6473,-0.432658245,OH,Coshocton County,,15555,6841,8312,0.439794278,0.534361941,1471,-0.094567663
39033,4518,13265,18702,0.241578441,0.70928243,8747,-0.467703989,OH,Crawford County,,19192,7207,11561,0.37552105,0.602386411,4354,-0.226865361
39035,383974,179894,583230,0.658357766,0.308444353,204080,0.349913413,OH,Cuyahoga County,,611512,420953,184475,0.688380604,0.301670286,236478,0.386710318
39037,4395,19698,25000,0.1758,0.78792,15303,-0.61212,OH,Darke County,,24807,6610,17745,0.266457048,0.715322288,11135,-0.44886524
39039,5282,11478,17795,0.296824951,0.645012644,6196,-0.348187693,OH,Defiance County,,17744,7438,9935,0.41918395,0.559907574,2497,-0.140723625
39041,39584,55660,100101,0.395440605,0.556038401,16076,-0.160597796,OH,Delaware County,,96330,36131,58980,0.375075262,0.612270321,22849,-0.237195059
39043,15692,19301,36730,0.427225701,0.525483256,3609,-0.098257555,OH,Erie County,,38262,20969,16655,0.548037217,0.435288276,4314,0.112748942
39045,24150,43163,70542,0.342349239,0.611876613,19013,-0.269527374,OH,Fairfield County,,70079,28831,40134,0.411407126,0.572696528,11303,-0.161289402
39047,2672,7763,10817,0.247018582,0.717666636,5091,-0.470648054,OH,Fayette County,,10677,4075,6456,0.381661515,0.604664232,2381,-0.223002716
39049,335961,192328,554711,0.60565051,0.34671748,143633,0.25893303,OH,Franklin County,,541751,325654,207941,0.601113796,0.383831317,117713,0.217282478
39051,5981,13419,20693,0.289034939,0.648480162,7438,-0.359445223,OH,Fulton County,,20757,8790,11521,0.4234716,0.555041673,2731,-0.131570073
39053,2564,9567,12588,0.20368605,0.760009533,7003,-0.556323483,OH,Gallia County,,9534,3418,5912,0.358506398,0.620096497,2494,-0.261590099
39055,17165,29577,48736,0.35220371,0.606881976,12412,-0.254678267,OH,Geauga County,,50125,19295,30104,0.384937656,0.600578554,10809,-0.215640898
39057,28023,47506,79633,0.35190185,0.596561727,19483,-0.244659877,OH,Greene County,,81075,31028,48683,0.38270737,0.600468702,17655,-0.217761332
39059,4286,11164,16156,0.265288438,0.691012627,6878,-0.425724189,OH,Guernsey County,,16403,7226,8811,0.440529171,0.537157837,1585,-0.096628665
39061,207587,169972,395000,0.525536709,0.430308861,37615,0.095227848,OH,Hamilton County,,402572,208508,188653,0.517939648,0.468619278,19855,0.04932037
39063,9419,23777,35216,0.267463653,0.675176056,14358,-0.407712403,OH,Hancock County,,34940,12192,22077,0.348941042,0.631854608,9885,-0.282913566
39065,2870,8541,12014,0.238887964,0.710920593,5671,-0.472032629,OH,Hardin County,,12147,4487,7337,0.369391619,0.604017453,2850,-0.234625834
39067,1663,5021,6956,0.239074181,0.721822887,3358,-0.482748706,OH,Harrison County,,6999,2895,3936,0.413630519,0.562366052,1041,-0.148735534
39069,3690,9136,13671,0.269914417,0.668275913,5446,-0.398361495,OH,Henry County,,13937,5513,8111,0.39556576,0.581976035,2598,-0.186410275
39071,3436,13005,17048,0.201548569,0.762846082,9569,-0.561297513,OH,Highland County,,17161,5772,11032,0.336344036,0.642852981,5260,-0.306508945
39073,3713,8282,12513,0.296731399,0.661871653,4569,-0.365140254,OH,Hocking County,,12442,6010,6150,0.483041312,0.494293522,140,-0.01125221
39075,1766,8578,10823,0.163171025,0.792571376,6812,-0.629400351,OH,Holmes County,,11355,2568,8563,0.226155878,0.754117129,5995,-0.527961251
39077,7080,15930,24332,0.290974848,0.654693408,8850,-0.36371856,OH,Huron County,,24077,10673,12821,0.443286124,0.532499896,2148,-0.089213772
39079,3142,9618,13239,0.237329103,0.726489916,6476,-0.489160813,OH,Jackson County,,12916,4965,7651,0.384406937,0.592366058,2686,-0.20795912
39081,9483,20668,31346,0.302526638,0.659350475,11185,-0.356823837,OH,Jefferson County,,32327,14960,16729,0.462771058,0.517493117,1769,-0.054722059
39083,7959,18563,27768,0.286624892,0.668503313,10604,-0.381878421,OH,Knox County,,27618,10154,16873,0.367658773,0.610942139,6719,-0.243283366
39085,45056,62627,112790,0.399468038,0.555253125,17571,-0.155785087,OH,Lake County,,114264,55219,57150,0.483258069,0.50015753,1931,-0.016899461
39087,6849,18240,25949,0.263940807,0.702917261,11391,-0.438976454,OH,Lawrence County,,25252,10454,14371,0.413987011,0.569103437,3917,-0.155116426
39089,26360,49346,79399,0.331994106,0.621493973,22986,-0.289499868,OH,Licking County,,77423,32264,43604,0.416723713,0.563191816,11340,-0.146468104
39091,4537,15586,21007,0.215975627,0.741943162,11049,-0.525967535,OH,Logan County,,20535,6789,13323,0.330606282,0.648794741,6534,-0.318188459
39093,64958,65346,136654,0.475346496,0.478185783,388,-0.002839288,OH,Lorain County,,138513,78112,58095,0.563932627,0.419419116,20017,0.144513511
39095,107363,74102,191684,0.56010413,0.38658417,33261,0.17351996,OH,Lucas County,,200850,129229,68100,0.643410505,0.339058999,61129,0.304351506
39097,4662,11319,16754,0.278261908,0.675599857,6657,-0.397337949,OH,Madison County,,17240,6700,10215,0.38863109,0.592517401,3515,-0.203886311
39099,56188,52808,112827,0.498001365,0.468043997,3380,0.029957368,OH,Mahoning County,,117571,74298,41702,0.63194155,0.354696311,32596,0.277245239
39101,7748,16563,25648,0.302089832,0.645781347,8815,-0.343691516,OH,Marion County,,26433,11933,13938,0.451443272,0.527295426,2005,-0.075852155
39103,31582,53811,89360,0.353424351,0.602182184,22229,-0.248757833,OH,Medina County,,88849,37841,49464,0.425902374,0.556719828,11623,-0.130817454
39105,2157,6869,9410,0.22922423,0.729968119,4712,-0.500743889,OH,Meigs County,,9979,3911,5782,0.391923038,0.579416775,1871,-0.187493737
39107,3335,17200,21315,0.156462585,0.806943467,13865,-0.650480882,OH,Mercer County,,21161,4609,16207,0.217806342,0.765890081,11598,-0.548083739
39109,12832,36311,51467,0.24932481,0.705520042,23479,-0.456195232,OH,Miami County,,50281,15731,33650,0.312861717,0.669238878,17919,-0.35637716
39111,1647,4781,6686,0.246335627,0.715076279,3134,-0.468740652,OH,Monroe County,,6743,3007,3540,0.445943942,0.524988877,533,-0.079044935
39113,117661,120766,249560,0.471473794,0.483915692,3105,-0.012441898,OH,Montgomery County,,254266,128983,121188,0.507275845,0.476618974,7795,0.030656871
39115,1711,4315,6290,0.272019078,0.686009539,2604,-0.413990461,OH,Morgan County,,6042,2772,3136,0.458788481,0.519033433,364,-0.060244952
39117,3711,11722,16186,0.229272211,0.724206104,8011,-0.494933893,OH,Morrow County,,15813,5780,9662,0.365522039,0.611016252,3882,-0.245494214
39119,10926,23588,36217,0.301681531,0.651296353,12662,-0.349614822,OH,Muskingum County,,35954,16327,18826,0.454108027,0.523613506,2499,-0.069505479
39121,1201,4441,5875,0.204425532,0.755914894,3240,-0.551489362,OH,Noble County,,5755,2082,3498,0.361772372,0.607819288,1416,-0.246046916
39123,8136,12389,21742,0.374206605,0.569818784,4253,-0.195612179,OH,Ottawa County,,21936,11214,10323,0.511214442,0.47059628,891,0.040618162
39125,2068,6359,8842,0.233883737,0.719181181,4291,-0.485297444,OH,Paulding County,,8912,3435,5248,0.385435368,0.588868941,1813,-0.203433573
39127,4072,9978,14647,0.278009149,0.681231652,5906,-0.403222503,OH,Perry County,,14673,6857,7498,0.46732093,0.511006611,641,-0.043685681
39129,6325,16482,23814,0.265600067,0.692113883,10157,-0.426513815,OH,Pickaway County,,23443,9335,13713,0.398199889,0.584950732,4378,-0.186750842
39131,3443,7669,11513,0.299053244,0.666116564,4226,-0.36706332,OH,Pike County,,11233,5490,5535,0.488738538,0.492744592,45,-0.004006054
39133,31463,38978,73968,0.425359615,0.526957603,7515,-0.101597988,OH,Portage County,,74029,38082,34465,0.514420025,0.465560794,3617,0.048859231
39135,4323,15376,20475,0.211135531,0.750964591,11053,-0.53982906,OH,Preble County,,19619,6005,13202,0.30608084,0.672919109,7197,-0.366838269
39137,2874,14704,18387,0.156306086,0.799695437,11830,-0.643389351,OH,Putnam County,,18126,4238,13563,0.23380779,0.748262165,9325,-0.514454375
39139,15629,35805,53739,0.290831612,0.666275889,20176,-0.375444277,OH,Richland County,,55954,21785,33057,0.38933767,0.590788862,11272,-0.201451192
39141,9905,17833,28955,0.342082542,0.615886721,7928,-0.273804179,OH,Ross County,,28961,13895,14582,0.479783157,0.503504713,687,-0.023721557
39143,9733,16045,27491,0.354043141,0.583645557,6312,-0.229602415,OH,Sandusky County,,28192,14035,13491,0.497836266,0.478540011,544,0.019296254
39145,8841,19742,29618,0.298500912,0.666554122,10901,-0.368053211,OH,Scioto County,,30023,14432,15023,0.480698131,0.50038304,591,-0.019684908
39147,7237,14559,23481,0.308206635,0.620033218,7322,-0.311826583,OH,Seneca County,,24633,10962,13025,0.445012788,0.52876223,2063,-0.083749442
39149,4143,18148,23110,0.179273042,0.785287754,14005,-0.606014712,OH,Shelby County,,23129,6065,16700,0.262224912,0.722037269,10635,-0.459812357
39151,66581,96345,170868,0.389663366,0.56385631,29764,-0.174192944,OH,Stark County,,176620,86314,86958,0.488698902,0.492345148,644,-0.003646246
39153,129922,109531,249937,0.519818994,0.438234435,20391,0.081584559,OH,Summit County,,259389,147146,108700,0.56727926,0.419061718,38446,0.148217542
39155,42130,48152,94073,0.447843696,0.511857813,6022,-0.064014117,OH,Trumbull County,,98703,59446,37545,0.602271461,0.380383575,21901,0.221887886
39157,11895,26105,40088,0.296722211,0.651192377,14210,-0.354470166,OH,Tuscarawas County,,39855,17516,21420,0.439493163,0.53744825,3904,-0.097955087
39159,7530,17601,26533,0.283797535,0.663362605,10071,-0.37956507,OH,Union County,,24947,8546,15947,0.34256624,0.639235179,7401,-0.296668938
39161,2667,10328,13584,0.196333922,0.760306243,7661,-0.56397232,OH,Van Wert County,,13586,3923,9433,0.288753128,0.69431768,5510,-0.405564552
39163,1332,3799,5393,0.246986835,0.704431671,2467,-0.457444836,OH,Vinton County,,5352,2382,2798,0.445067265,0.522795217,416,-0.077727952
39165,33036,75947,114254,0.289145238,0.66472071,42911,-0.375575472,OH,Warren County,,108008,31907,74626,0.295413303,0.690930301,42719,-0.395516999
39167,7841,19901,28992,0.270453918,0.68643074,12060,-0.415976821,OH,Washington County,,28798,11333,16921,0.393534273,0.587575526,5588,-0.194041253
39169,14670,31622,48550,0.302162719,0.651328527,16952,-0.349165808,OH,Wayne County,,49356,18932,29450,0.383580517,0.596685307,10518,-0.21310479
39171,4287,11706,16938,0.253099539,0.69110875,7419,-0.43800921,OH,Williams County,,17286,7045,9863,0.407555247,0.570577346,2818,-0.163022099
39173,26440,31734,62287,0.424486651,0.509480309,5294,-0.084993658,OH,Wood County,,61967,31596,28997,0.509884293,0.467942615,2599,0.041941679
39175,2484,7346,10396,0.238938053,0.70661793,4862,-0.467679877,OH,Wyandot County,,10254,3962,6054,0.386385801,0.590403745,2092,-0.204017944
40001,1374,4753,6468,0.212430427,0.734848485,3379,-0.522418058,OK,Adair County,,6472,2110,4362,0.326019778,0.673980222,2252,-0.347960445
40003,216,1931,2256,0.095744681,0.855939716,1715,-0.760195035,OK,Alfalfa County,,1817,278,1539,0.15299945,0.84700055,1261,-0.694001101
40005,795,4068,5002,0.158936425,0.81327469,3273,-0.654338265,OK,Atoka County,,4775,1241,3534,0.259895288,0.740104712,2293,-0.480209424
40007,176,1987,2237,0.078676799,0.888243183,1811,-0.809566384,OK,Beaver County,,2300,243,2057,0.105652174,0.894347826,1814,-0.788695652
40009,958,6287,7529,0.127241334,0.835037854,5329,-0.70779652,OK,Beckham County,,6909,1413,5496,0.204515849,0.795484151,4083,-0.590968302
40011,711,2884,3793,0.187450567,0.760348009,2173,-0.572897443,OK,Blaine County,,3815,991,2824,0.259764089,0.740235911,1833,-0.480471822
40013,2793,10449,13775,0.202758621,0.758548094,7656,-0.555789474,OK,Bryan County,,12721,3533,9188,0.277729738,0.722270262,5655,-0.444540524
40015,2418,6473,9336,0.258997429,0.693337618,4055,-0.434340189,OK,Caddo County,,8811,3151,5660,0.357621155,0.642378845,2509,-0.284757689
40017,11666,39969,55250,0.211149321,0.723420814,28303,-0.512271493,OK,Canadian County,,46148,10533,35615,0.228243911,0.771756089,25082,-0.543512178
40019,4002,13751,18533,0.215939136,0.741973777,9749,-0.526034641,OK,Carter County,,17120,4907,12213,0.286623832,0.713376168,7306,-0.426752336
40021,5455,9992,16487,0.330866743,0.606053254,4537,-0.275186511,OK,Cherokee County,,14288,6137,8151,0.429521277,0.570478723,2014,-0.140957447
40023,1064,4202,5419,0.196346189,0.775419819,3138,-0.57907363,OK,Choctaw County,,5066,1494,3572,0.294907225,0.705092775,2078,-0.410185551
40025,70,962,1077,0.064995357,0.893221913,892,-0.828226555,OK,Cimarron County,,1197,115,1082,0.096073517,0.903926483,967,-0.807852966
40027,38790,62469,109326,0.354810384,0.571401131,23679,-0.216590747,OK,Cleveland County,,93720,34701,59019,0.370262484,0.629737516,24318,-0.259475032
40029,411,1892,2393,0.17175094,0.790639365,1481,-0.618888425,OK,Coal County,,2357,648,1709,0.274925753,0.725074247,1061,-0.450148494
40031,11439,19153,32504,0.351925917,0.589250554,7714,-0.237324637,OK,Comanche County,,30174,12517,17657,0.414827335,0.585172665,5140,-0.17034533
40033,424,2054,2602,0.162951576,0.789392775,1630,-0.626441199,OK,Cotton County,,2453,657,1796,0.267835304,0.732164696,1139,-0.464329393
40035,1249,4279,5778,0.216164763,0.74056767,3030,-0.524402908,OK,Craig County,,5298,1746,3552,0.329558324,0.670441676,1806,-0.340883352
40037,5834,21539,28786,0.202667964,0.748245675,15705,-0.545577711,OK,Creek County,,26078,7114,18964,0.272796994,0.727203006,11850,-0.454406013
40039,2102,7818,10531,0.199601177,0.742379641,5716,-0.542778464,OK,Custer County,,9800,2358,7442,0.240612245,0.759387755,5084,-0.51877551
40041,3306,11796,15680,0.210841837,0.752295918,8490,-0.541454082,OK,Delaware County,,14232,4176,10056,0.293423272,0.706576728,5880,-0.413153457
40043,222,1964,2246,0.098842386,0.874443455,1742,-0.775601069,OK,Dewey County,,2070,301,1769,0.145410628,0.854589372,1468,-0.709178744
40045,155,1610,1826,0.084884995,0.881708653,1455,-0.796823658,OK,Ellis County,,1801,226,1575,0.125485841,0.874514159,1349,-0.749028318
40047,4391,15998,21692,0.202424857,0.737506915,11607,-0.535082058,OK,Garfield County,,19908,4732,15176,0.23769339,0.76230661,10444,-0.524613221
40049,1852,8243,10531,0.175861742,0.782736682,6391,-0.606874941,OK,Garvin County,,9478,2556,6922,0.269677147,0.730322853,4366,-0.460645706
40051,3878,17293,22257,0.174237319,0.776969043,13415,-0.602731725,OK,Grady County,,19598,4780,14818,0.243902439,0.756097561,10038,-0.512195122
40053,287,1827,2200,0.130454545,0.830454545,1540,-0.7,OK,Grant County,,2067,393,1674,0.190130624,0.809869376,1281,-0.619738752
40055,323,1482,1896,0.17035865,0.78164557,1159,-0.61128692,OK,Greer County,,1832,488,1344,0.266375546,0.733624454,856,-0.467248908
40057,224,714,975,0.22974359,0.732307692,490,-0.502564103,OK,Harmon County,,923,264,659,0.286023835,0.713976165,395,-0.427952329
40059,131,1307,1485,0.088215488,0.88013468,1176,-0.791919192,OK,Harper County,,1434,173,1261,0.120641562,0.879358438,1088,-0.758716876
40061,882,3697,4734,0.186311787,0.780946346,2815,-0.594634559,OK,Haskell County,,4244,1175,3069,0.276861451,0.723138549,1894,-0.446277097
40063,961,3387,4525,0.212375691,0.748508287,2426,-0.536132597,OK,Hughes County,,4206,1370,2836,0.325725155,0.674274845,1466,-0.348549691
40065,1473,5969,7806,0.188700999,0.764668204,4496,-0.575967205,OK,Jackson County,,7915,1953,5962,0.246746684,0.753253316,4009,-0.506506633
40067,365,1905,2345,0.15565032,0.812366738,1540,-0.656716418,OK,Jefferson County,,2234,602,1632,0.269471799,0.730528201,1030,-0.461056401
40069,782,3081,4001,0.195451137,0.770057486,2299,-0.574606348,OK,Johnston County,,3778,1134,2644,0.300158814,0.699841186,1510,-0.399682372
40071,3734,12168,16795,0.222328074,0.72450134,8434,-0.502173266,OK,Kay County,,16122,4624,11498,0.28681305,0.71318695,6874,-0.426373899
40073,783,5151,6123,0.127878491,0.841254287,4368,-0.713375796,OK,Kingfisher County,,5354,844,4510,0.157639148,0.842360852,3666,-0.684721703
40075,766,2593,3489,0.219547148,0.743192892,1827,-0.523645744,OK,Kiowa County,,3410,1101,2309,0.3228739,0.6771261,1208,-0.354252199
40077,797,3094,4050,0.196790123,0.763950617,2297,-0.567160494,OK,Latimer County,,3789,1169,2620,0.308524677,0.691475323,1451,-0.382950647
40079,3245,13346,17199,0.18867376,0.775975347,10101,-0.587301587,OK,Le Flore County,,15830,4658,11172,0.294251421,0.705748579,6514,-0.411497157
40081,2423,10838,14001,0.173059067,0.774087565,8415,-0.601028498,OK,Lincoln County,,12807,3265,9542,0.254938705,0.745061295,6277,-0.490122589
40083,4239,13613,18948,0.223717543,0.718439941,9374,-0.494722398,OK,Logan County,,16983,4686,12297,0.275922982,0.724077018,7611,-0.448154036
40085,735,2920,3787,0.194085028,0.771058886,2185,-0.576973858,OK,Love County,,3470,1034,2436,0.297982709,0.702017291,1402,-0.404034582
40087,2893,13151,16839,0.171803551,0.780984619,10258,-0.609181068,OK,McClain County,,14299,3191,11108,0.223162459,0.776837541,7917,-0.553675082
40089,1799,8642,10709,0.167989542,0.806984779,6843,-0.638995238,OK,McCurtain County,,10073,2440,7633,0.242231709,0.757768291,5193,-0.515536583
40091,2122,5501,7958,0.266649912,0.691254084,3379,-0.424604172,OK,McIntosh County,,7265,2767,4498,0.380867171,0.619132829,1731,-0.238265657
40093,310,2940,3399,0.091203295,0.864960282,2630,-0.773756987,OK,Major County,,3146,446,2700,0.141767324,0.858232676,2254,-0.716465353
40095,1095,4202,5487,0.199562603,0.765810097,3107,-0.566247494,OK,Marshall County,,5140,1396,3744,0.271595331,0.728404669,2348,-0.456809339
40097,3423,11550,15712,0.217858961,0.735106925,8127,-0.517247963,OK,Mayes County,,14456,4822,9634,0.333563918,0.666436082,4812,-0.332872164
40099,1086,4173,5525,0.196561086,0.755294118,3087,-0.558733032,OK,Murray County,,5146,1540,3606,0.299261562,0.700738438,2066,-0.401476875
40101,7969,15029,24193,0.3293928,0.621212747,7060,-0.291819948,OK,Muskogee County,,23335,9943,13392,0.426098136,0.573901864,3449,-0.147803728
40103,901,3707,4870,0.185010267,0.761190965,2806,-0.576180698,OK,Noble County,,4626,1142,3484,0.246865543,0.753134457,2342,-0.506268915
40105,742,3321,4237,0.175123908,0.783809299,2579,-0.608685391,OK,Nowata County,,4076,1244,2832,0.305201178,0.694798822,1588,-0.389597645
40107,943,2791,3933,0.239766082,0.70963641,1848,-0.469870328,OK,Okfuskee County,,3579,1251,2328,0.349538977,0.650461023,1077,-0.300922045
40109,112661,141429,273609,0.411759116,0.516901856,28768,-0.10514274,OK,Oklahoma County,,256337,106812,149525,0.416685847,0.583314153,42713,-0.166628306
40111,4379,8926,13924,0.314492962,0.641051422,4547,-0.32655846,OK,Okmulgee County,,13128,5416,7712,0.412553321,0.587446679,2296,-0.174893358
40113,5593,12559,18942,0.295269771,0.663023968,6966,-0.367754197,OK,Osage County,,17913,6695,11218,0.373750907,0.626249093,4523,-0.252498186
40115,2584,7627,10686,0.241811716,0.713737601,5043,-0.471925884,OK,Ottawa County,,9973,3508,6465,0.351749724,0.648250276,2957,-0.296500551
40117,1341,4716,6346,0.211314214,0.743145288,3375,-0.531831075,OK,Pawnee County,,6041,1813,4228,0.300115875,0.699884125,2415,-0.39976825
40119,8785,16644,27749,0.316587985,0.599805398,7859,-0.283217413,OK,Payne County,,25660,9193,16467,0.358261886,0.641738114,7274,-0.283476228
40121,3704,12740,17250,0.214724638,0.738550725,9036,-0.523826087,OK,Pittsburg County,,15598,4813,10785,0.308565201,0.691434799,5972,-0.382869599
40123,3633,10420,14814,0.245240988,0.703388686,6787,-0.458147698,OK,Pontotoc County,,12855,3934,8921,0.306028783,0.693971217,4987,-0.387942435
40125,6005,17826,25417,0.236259197,0.701341622,11821,-0.465082425,OK,Pottawatomie County,,23422,7182,16240,0.306634788,0.693365212,9058,-0.386730424
40127,748,3581,4483,0.166852554,0.798795449,2833,-0.631942895,OK,Pushmataha County,,4130,1043,3087,0.252542373,0.747457627,2044,-0.494915254
40129,151,1546,1758,0.08589306,0.879408419,1395,-0.793515358,OK,Roger Mills County,,1674,272,1402,0.162485066,0.837514934,1130,-0.675029869
40131,7895,30893,40834,0.193343782,0.756550913,22998,-0.563207131,OK,Rogers County,,36677,9146,27531,0.249366088,0.750633912,18385,-0.501267825
40133,2067,5612,8032,0.257345618,0.698705179,3545,-0.441359562,OK,Seminole County,,7449,2597,4852,0.348637401,0.651362599,2255,-0.302725198
40135,3061,10888,14437,0.212024659,0.754173305,7827,-0.542148646,OK,Sequoyah County,,13766,4193,9573,0.304591021,0.695408979,5380,-0.390817957
40137,3084,14166,17886,0.172425361,0.792016102,11082,-0.619590741,OK,Stephens County,,16846,3939,12907,0.233824053,0.766175947,8968,-0.532351894
40139,855,4615,5771,0.148154566,0.799688096,3760,-0.65153353,OK,Texas County,,5762,854,4908,0.148212426,0.851787574,4054,-0.703575148
40141,657,1944,2706,0.242793792,0.718403548,1287,-0.475609756,OK,Tillman County,,2719,906,1813,0.333210739,0.666789261,907,-0.333578522
40143,87663,143985,246557,0.355548616,0.583982608,56322,-0.228433993,OK,Tulsa County,,227541,82633,144908,0.36315653,0.63684347,62275,-0.27368694
40145,6711,22967,31246,0.214779492,0.735038085,16256,-0.520258593,OK,Wagoner County,,28621,7773,20848,0.271583802,0.728416198,13075,-0.456832396
40147,5047,15810,22208,0.227260447,0.71190562,10763,-0.484645173,OK,Washington County,,21199,5532,15667,0.260955705,0.739044295,10135,-0.478088589
40149,588,3851,4628,0.127052723,0.832108902,3263,-0.70505618,OK,Washita County,,4303,821,3482,0.190797118,0.809202882,2661,-0.618405763
40151,521,2945,3665,0.142155525,0.803547067,2424,-0.661391542,OK,Woods County,,3395,670,2725,0.197349043,0.802650957,2055,-0.605301915
40153,871,6329,7573,0.115013865,0.835732207,5458,-0.720718341,OK,Woodward County,,7065,1129,5936,0.15980184,0.84019816,4807,-0.68039632
41001,1781,6160,8479,0.210048355,0.726500767,4379,-0.516452412,OR,Baker County,,8351,2364,5692,0.283079871,0.681595019,3328,-0.398515148
41003,28431,13030,45577,0.623801479,0.285889813,15401,0.337911666,OR,Benton County,,44262,27662,14922,0.624960463,0.337128914,12740,0.287831549
41005,90187,79062,182136,0.495162955,0.434082224,11125,0.061080731,OR,Clackamas County,,185564,94013,87551,0.50663383,0.471810265,6462,0.034823565
41007,8899,7794,18158,0.490087014,0.429232294,1105,0.06085472,OR,Clatsop County,,17206,9616,7101,0.558874811,0.41270487,2515,0.146169941
41009,9959,12967,25077,0.397136819,0.517087371,3008,-0.119950552,OR,Columbia County,,23298,11843,10645,0.508326895,0.456906172,1198,0.051420723
41011,10355,17699,30181,0.34309665,0.586428548,7344,-0.243331898,OR,Coos County,,27926,12628,14398,0.452195087,0.515576882,1770,-0.063381795
41013,2591,8388,11638,0.222632755,0.720742396,5797,-0.498109641,OR,Crook County,,10109,3081,6769,0.304777921,0.669601345,3688,-0.364823425
41015,4253,7157,12163,0.349667023,0.588423909,2904,-0.238756886,OR,Curry County,,11529,4611,6577,0.399947957,0.570474456,1966,-0.170526498
41017,40222,43667,90584,0.444029851,0.48206085,3445,-0.038030999,OR,Deschutes County,,77441,34985,40670,0.451763278,0.525174003,5685,-0.073410726
41019,13891,34112,51350,0.270516066,0.664303797,20221,-0.393787731,OR,Douglas County,,49062,17032,30588,0.347152582,0.623456035,13556,-0.276303453
41021,221,632,937,0.235859125,0.674493063,411,-0.438633938,OR,Gilliam County,,1044,371,637,0.355363985,0.610153257,266,-0.254789272
41023,732,3187,4171,0.175497483,0.764085351,2455,-0.588587869,OR,Grant County,,3778,834,2848,0.22075172,0.75383801,2014,-0.533086289
41025,682,2904,3850,0.177142857,0.754285714,2222,-0.577142857,OR,Harney County,,3535,829,2599,0.234512023,0.735219236,1770,-0.500707214
41027,6359,3223,10383,0.612443417,0.310411249,3136,0.302032168,OR,Hood River County,,9662,5977,3400,0.618608984,0.351894018,2577,0.266714966
41029,43550,53083,103789,0.419601306,0.511451117,9533,-0.091849811,OR,Jackson County,,91955,42341,46974,0.460453483,0.510836822,4633,-0.05038334
41031,2892,5337,8874,0.325895876,0.601419878,2445,-0.275524003,OR,Jefferson County,,7978,3238,4576,0.405866132,0.573577338,1338,-0.167711206
41033,13223,26582,42613,0.310304367,0.623800249,13359,-0.313495882,OR,Josephine County,,39679,14929,23636,0.376244361,0.595680335,8707,-0.219435974
41035,7080,20170,29240,0.242134063,0.689808482,13090,-0.447674419,OR,Klamath County,,27530,8140,18654,0.295677443,0.677588086,10514,-0.381910643
41037,628,3001,3814,0.164656529,0.786837965,2373,-0.622181437,OR,Lake County,,3676,769,2801,0.209194777,0.761969532,2032,-0.552774755
41039,100497,66218,181072,0.555011266,0.365699832,34279,0.189311434,OR,Lane County,,166176,99891,60979,0.601115685,0.366954313,38912,0.234161371
41041,12300,9901,24035,0.511753693,0.411940919,2399,0.099812773,OR,Lincoln County,,22612,13277,8623,0.587166106,0.381346188,4654,0.205819919
41043,17456,32683,54724,0.318982531,0.597233389,15227,-0.278250859,OR,Linn County,,49987,19893,28482,0.397963471,0.569788145,8589,-0.171824674
41045,2213,7141,9950,0.22241206,0.717688442,4928,-0.495276382,OR,Malheur County,,9711,2701,6751,0.278138194,0.69519102,4050,-0.417052827
41047,48803,54336,110804,0.440444388,0.490379409,5533,-0.04993502,OR,Marion County,,115519,54337,58435,0.470372839,0.505847523,4098,-0.035474684
41049,1004,2698,3989,0.251692153,0.67635999,1694,-0.424667837,OR,Morrow County,,3838,1189,2524,0.309796769,0.657634184,1335,-0.347837415
41051,271754,63055,357762,0.759594367,0.176248456,208699,0.583345912,OR,Multnomah County,,344614,261222,71947,0.758013313,0.208775616,189275,0.549237698
41053,15741,18333,37030,0.425087767,0.495085066,2592,-0.069997299,OR,Polk County,,33996,15761,17377,0.463613366,0.51114837,1616,-0.047535004
41055,202,726,983,0.205493388,0.738555443,524,-0.533062055,OR,Sherman County,,1019,317,677,0.311089303,0.66437684,360,-0.353287537
41057,5701,6486,13261,0.429907247,0.489103386,785,-0.059196139,OR,Tillamook County,,12346,6249,5670,0.50615584,0.459258059,579,0.046897781
41059,7466,16775,26116,0.285878389,0.642326543,9309,-0.356448154,OR,Umatilla County,,24623,8499,15425,0.34516509,0.626446818,6926,-0.281281728
41061,3221,8378,12465,0.25840353,0.672121941,5157,-0.413718412,OR,Union County,,11905,3943,7608,0.331205376,0.639059219,3665,-0.307853843
41063,1097,2825,4177,0.262628681,0.67632272,1728,-0.413694039,OR,Wallowa County,,4152,1252,2796,0.301541426,0.673410405,1544,-0.371868979
41065,4634,5721,11251,0.4118745,0.508488134,1087,-0.096613634,OR,Wasco County,,10550,5066,5152,0.480189573,0.488341232,86,-0.008151659
41067,137818,75903,232034,0.593956058,0.327120163,61915,0.266835895,OR,Washington County,,216473,124431,86551,0.574810715,0.399823535,37880,0.174987181
41069,153,583,792,0.193181818,0.736111111,430,-0.542929293,OR,Wheeler County,,841,262,542,0.311533888,0.644470868,280,-0.33293698
41071,18635,22589,45116,0.413046369,0.500687118,3954,-0.087640748,OR,Yamhill County,,41750,18906,21711,0.452838323,0.520023952,2805,-0.067185629
42001,14077,31249,47138,0.298633799,0.662925877,17172,-0.364292079,PA,Adams County,,41973,14893,26490,0.354823339,0.631120006,11597,-0.276296667
42003,363017,257488,643173,0.564415795,0.400340188,105529,0.164075606,PA,Allegheny County,,614671,348151,259304,0.566402189,0.421858197,88847,0.144543992
42005,6849,22676,30446,0.224955659,0.744794062,15827,-0.519838402,PA,Armstrong County,,28322,8694,19231,0.306969847,0.679012782,10537,-0.372042935
42007,30225,46081,79036,0.382420669,0.583038109,15856,-0.20061744,PA,Beaver County,,80015,36833,42118,0.460326189,0.526376304,5285,-0.066050116
42009,3613,19455,23504,0.153718516,0.82773145,15842,-0.674012934,PA,Bedford County,,21444,4730,16509,0.22057452,0.769865697,11779,-0.549291177
42011,75169,93094,175934,0.427256812,0.52914161,17925,-0.101884798,PA,Berks County,,163253,79895,80857,0.489393763,0.495286457,962,-0.005892694
42013,13093,37224,52029,0.251648119,0.715447154,24131,-0.463799035,PA,Blair County,,47631,15516,31500,0.325754236,0.661334005,15984,-0.335579769
42015,6263,17957,25399,0.246584511,0.706996338,11694,-0.460411827,PA,Bradford County,,22501,8291,13827,0.368472512,0.614506022,5536,-0.24603351
42017,165861,163873,342572,0.484163913,0.478360753,1988,0.00580316,PA,Bucks County,,319407,159598,155876,0.4996697,0.488016856,3722,0.011652844
42019,26834,61388,92027,0.291588338,0.6670651,34554,-0.375476762,PA,Butler County,,88924,28385,59416,0.319205164,0.668166074,31031,-0.34896091
42021,17798,40510,60167,0.295809996,0.673292669,22712,-0.377482673,PA,Cambria County,,57718,23181,33464,0.401625143,0.579784469,10283,-0.178159326
42023,469,1495,2024,0.231719368,0.738636364,1026,-0.506916996,PA,Cameron County,,1967,677,1264,0.344178953,0.642602949,587,-0.298423996
42025,8917,18714,28721,0.310469691,0.651578984,9797,-0.341109293,PA,Carbon County,,24232,11040,12710,0.455595906,0.524513041,1670,-0.068917134
42027,36555,35099,75394,0.484852906,0.465541024,1456,0.019311882,PA,Centre County,,68801,33677,33697,0.489484164,0.489774858,20,-0.000290693
42029,140188,115582,266637,0.525763491,0.433480725,24606,0.092282766,PA,Chester County,,248295,122232,123280,0.492285386,0.496506172,1048,-0.004220786
42031,4256,12545,17481,0.243464333,0.717636291,8289,-0.474171958,PA,Clarion County,,15227,4731,10228,0.310698102,0.671701583,5497,-0.361003481
42033,7700,23909,32692,0.235531629,0.731341001,16209,-0.495809372,PA,Clearfield County,,31894,11093,20303,0.347808365,0.636577413,9210,-0.288769047
42035,4533,9701,14839,0.305478806,0.653750253,5168,-0.348271447,PA,Clinton County,,12663,5503,6941,0.434573166,0.548132354,1438,-0.113559188
42037,8502,17387,27127,0.313414679,0.640948133,8885,-0.327533454,PA,Columbia County,,24305,10424,13445,0.428882946,0.553178358,3021,-0.124295412
42039,10215,23912,35563,0.287236735,0.67238422,13697,-0.385147485,PA,Crawford County,,33089,13024,19497,0.393605126,0.589229049,6473,-0.195623923
42041,44282,65649,115068,0.384833316,0.570523517,21367,-0.185690201,PA,Cumberland County,,109964,43983,64365,0.399976356,0.585327926,20382,-0.18535157
42043,64287,60620,130160,0.493907498,0.465734481,3667,0.028173018,PA,Dauphin County,,122625,64209,56838,0.523620795,0.463510703,7371,0.060110092
42045,169169,106559,284832,0.593925542,0.374111757,62610,0.219813785,PA,Delaware County,,272853,164805,105270,0.604006553,0.385812141,59535,0.218194412
42047,3637,9704,13854,0.262523459,0.700447524,6067,-0.437924065,PA,Elk County,,12425,5144,7099,0.414004024,0.571348089,1955,-0.157344064
42049,54820,57168,117240,0.467587854,0.487615148,2348,-0.020027294,PA,Erie County,,112732,65136,46102,0.577795125,0.408952205,19034,0.168842919
42051,17826,34388,53426,0.33365777,0.643656647,16562,-0.309998877,PA,Fayette County,,48196,21841,25845,0.453170388,0.536247821,4004,-0.083077434
42053,626,1680,2398,0.261050876,0.70058382,1054,-0.439532944,PA,Forest County,,2308,894,1381,0.387348354,0.598353553,487,-0.211005199
42055,17322,49554,69345,0.249794506,0.714600909,32232,-0.464806403,PA,Franklin County,,62802,18910,43072,0.30110506,0.685838031,24162,-0.38473297
42057,904,5676,6743,0.134064956,0.841761827,4772,-0.707696871,PA,Fulton County,,6148,1297,4780,0.210962915,0.777488614,3483,-0.566525699
42059,4157,10394,14955,0.277967235,0.695018388,6237,-0.417051153,PA,Greene County,,13726,5564,7985,0.405362087,0.581742678,2421,-0.176380592
42061,4487,14369,19496,0.230149774,0.737022979,9882,-0.506873205,PA,Huntingdon County,,17587,5383,11953,0.306078353,0.679649741,6570,-0.373571388
42063,11468,24920,37728,0.303965225,0.660517388,13452,-0.356552163,PA,Indiana County,,36180,14403,21187,0.398092869,0.585599779,6784,-0.18750691
42065,3437,14533,18551,0.185273031,0.783407903,11096,-0.598134871,PA,Jefferson County,,17072,4535,12288,0.265639644,0.71977507,7753,-0.454135426
42067,1810,8234,10402,0.174004999,0.791578543,6424,-0.617573544,PA,Juniata County,,9480,2533,6821,0.267194093,0.719514768,4288,-0.452320675
42069,51593,48102,102740,0.502170528,0.468191551,3491,0.033978976,PA,Lackawanna County,,97116,61309,34730,0.631296594,0.357613576,26579,0.273683018
42071,90066,137145,239151,0.376607248,0.573466136,47079,-0.196858888,PA,Lancaster County,,219677,87108,129364,0.396527629,0.588882769,42256,-0.19235514
42073,13933,25323,40555,0.343558131,0.624411293,11390,-0.280853162,PA,Lawrence County,,38816,17427,20915,0.448964345,0.538824196,3488,-0.089859852
42075,17860,38804,58906,0.303194921,0.65874444,20944,-0.35554952,PA,Lebanon County,,53771,18975,34010,0.352885384,0.632497071,15035,-0.279611687
42077,77087,70285,153031,0.503734537,0.459286027,6802,0.04444851,PA,Lehigh County,,144922,77029,66091,0.531520404,0.456045321,10938,0.075475083
42079,51454,77508,132731,0.387656237,0.583947985,26054,-0.196291748,PA,Luzerne County,,123741,63974,57969,0.516999216,0.468470434,6005,0.048528782
42081,12926,35475,50294,0.257008788,0.705352527,22549,-0.448343739,PA,Lycoming County,,46214,15104,30490,0.326827368,0.659756784,15386,-0.332929415
42083,3802,11159,15572,0.244156178,0.71660673,7357,-0.472450552,PA,McKean County,,15014,5260,9494,0.350339683,0.632343146,4234,-0.282003463
42085,17631,30034,49594,0.355506715,0.605597451,12403,-0.250090737,PA,Mercer County,,48065,23082,24304,0.480224696,0.505648601,1222,-0.025423905
42087,3563,14050,18239,0.195350622,0.770327321,10487,-0.574976698,PA,Mifflin County,,16311,4259,11893,0.261112133,0.729139844,7634,-0.468027711
42089,31930,31706,65944,0.484198714,0.480801893,224,0.003396822,PA,Monroe County,,59312,33431,25100,0.56364648,0.423185865,8331,0.140460615
42091,251063,160803,427489,0.587296983,0.376157047,90260,0.211139936,PA,Montgomery County,,401787,227561,169903,0.566372232,0.422868336,57658,0.143503896
42093,2851,5274,8535,0.334036321,0.617926186,2423,-0.283889865,PA,Montour County,,7787,3026,4636,0.388596379,0.595351226,1610,-0.206754848
42095,65936,71384,142775,0.461817545,0.499975486,5448,-0.038157941,PA,Northampton County,,125883,65014,59242,0.5164637,0.4706116,5772,0.045852101
42097,9184,24418,34971,0.262617597,0.698235681,15234,-0.435618084,PA,Northumberland County,,31512,12392,18516,0.393247017,0.587585682,6124,-0.194338665
42099,4630,15613,21153,0.218881483,0.738098615,10983,-0.519217132,PA,Perry County,,18240,5430,12511,0.297697368,0.685910088,7081,-0.388212719
42101,560542,105418,680227,0.824051383,0.154974736,455124,0.669076646,PA,Philadelphia County,,653598,557024,91840,0.85224251,0.140514506,465184,0.711728004
42103,9247,16035,26066,0.354753318,0.615169186,6788,-0.260415867,PA,Pike County,,23164,10170,12713,0.439043343,0.548825764,2543,-0.109782421
42105,1300,6247,7777,0.167159573,0.803266041,4947,-0.636106468,PA,Potter County,,7205,1892,5199,0.26259542,0.721582235,3307,-0.458986815
42107,16724,43937,62750,0.266517928,0.700191235,27213,-0.433673307,PA,Schuylkill County,,57505,24453,32156,0.425232588,0.559186158,7703,-0.133953569
42109,3991,11710,16333,0.244351926,0.716953407,7719,-0.472601482,PA,Snyder County,,14962,4672,10050,0.31225772,0.671701644,5378,-0.359443925
42111,7367,27347,35730,0.206185278,0.765379233,19980,-0.559193955,PA,Somerset County,,33875,9420,23935,0.278081181,0.706568266,14515,-0.428487085
42113,756,2318,3168,0.238636364,0.731691919,1562,-0.493055556,PA,Sullivan County,,2934,1028,1859,0.350374915,0.633605999,831,-0.283231084
42115,5065,13295,19200,0.263802083,0.692447917,8230,-0.428645833,PA,Susquehanna County,,17930,6891,10735,0.384327942,0.598717234,3844,-0.214389292
42117,3642,12928,17334,0.210107304,0.745817469,9286,-0.535710165,PA,Tioga County,,15943,5053,10599,0.316941604,0.664805871,5546,-0.347864266
42119,6138,10605,17400,0.352758621,0.609482759,4467,-0.256724138,PA,Union County,,16187,6063,9863,0.374559832,0.609316118,3800,-0.234756286
42121,5889,15254,22096,0.266518827,0.690351195,9365,-0.423832368,PA,Venango County,,20775,7469,12928,0.359518652,0.622286402,5459,-0.26276775
42123,4828,12032,17624,0.273944621,0.682705402,7204,-0.408760781,PA,Warren County,,16462,6768,9415,0.41112866,0.571923217,2647,-0.160794557
42125,34436,58941,96945,0.355211718,0.607983908,24505,-0.25277219,PA,Washington County,,90078,38503,50455,0.427440663,0.560125669,11952,-0.132685006
42127,6398,15269,22365,0.286071987,0.682718533,8871,-0.396646546,PA,Wayne County,,20966,8138,12531,0.388152246,0.597681961,4393,-0.209529715
42129,59506,116427,181740,0.327423792,0.640623968,56921,-0.313200176,PA,Westmoreland County,,168709,63380,103429,0.375676461,0.613061544,40049,-0.237385083
42131,3573,8375,12418,0.287727492,0.674424223,4802,-0.386696731,PA,Wyoming County,,11214,4812,6189,0.429106474,0.551899411,1377,-0.122792937
42133,67428,126933,203153,0.331907479,0.624814795,59505,-0.292907316,PA,York County,,186394,72126,111576,0.386954516,0.598602959,39450,-0.211648444
44001,14532,8910,24691,0.588554534,0.360860232,5622,0.227694302,RI,Bristol County,,24563,14943,9216,0.608354028,0.375198469,5727,0.233155559
44003,37582,38141,79691,0.471596542,0.478611136,559,-0.007014594,RI,Kent County,,77247,44966,30786,0.582106748,0.398539749,14180,0.183566999
44005,22680,14975,39761,0.570408189,0.376625336,7705,0.193782853,RI,Newport County,,40545,23507,16343,0.579775558,0.403082994,7164,0.176692564
44007,141597,90321,241818,0.585551944,0.373508176,51276,0.212043768,RI,Providence County,,234092,156022,74344,0.666498642,0.317584539,81678,0.348914102
44009,33511,27074,64160,0.522303616,0.421976309,6437,0.100327307,RI,Washington County,,60933,34904,24666,0.572825891,0.404805278,10238,0.168020613
45001,3712,6742,10724,0.3461395,0.628683327,3030,-0.282543827,SC,Abbeville County,,10577,4507,5923,0.426113265,0.559988655,1416,-0.13387539
45003,25426,45981,74773,0.340042529,0.614941222,20555,-0.274898693,SC,Aiken County,,66049,23953,41157,0.362654999,0.623128284,17204,-0.260473285
45005,2722,788,3578,0.760760201,0.220234768,1934,0.540525433,SC,Allendale County,,4257,3335,894,0.783415551,0.210007047,2441,0.573408504
45007,21040,56109,80296,0.262030487,0.698777025,35069,-0.436746538,SC,Anderson County,,71901,22315,48493,0.310357297,0.674441246,26178,-0.364083949
45009,3886,2197,6195,0.627280065,0.354640839,1689,0.272639225,SC,Bamberg County,,6854,4600,2190,0.67114094,0.319521447,2410,0.351619492
45011,4395,4888,9479,0.463656504,0.51566621,493,-0.052009706,SC,Barnwell County,,9913,5182,4655,0.522747907,0.469585393,527,0.053162514
45013,29577,39986,72770,0.406444964,0.549484678,10409,-0.143039714,SC,Beaufort County,,73115,29775,42580,0.407235177,0.582370239,12805,-0.175135061
45015,30492,44223,78919,0.386370836,0.560359356,13731,-0.17398852,SC,Berkeley County,,61111,24239,35764,0.396638903,0.585230155,11525,-0.188591252
45017,3569,3785,7553,0.472527473,0.501125381,216,-0.028597908,SC,Calhoun County,,7830,4043,3705,0.516347382,0.473180077,338,0.043167305
45019,89048,75233,175850,0.506386125,0.427824851,13815,0.078561274,SC,Charleston County,,160854,81027,77248,0.503730091,0.480236736,3779,0.023493354
45021,6089,15165,21754,0.279902547,0.697113175,9076,-0.417210628,SC,Cherokee County,,20753,7219,13306,0.347853322,0.641160314,6087,-0.293306992
45023,6582,7272,14202,0.463455851,0.512040558,690,-0.048584706,SC,Chester County,,14324,7839,6336,0.547263334,0.442334543,1503,0.104928791
45025,7125,9576,17128,0.415985521,0.55908454,2451,-0.143099019,SC,Chesterfield County,,16576,7942,8488,0.479126448,0.512065637,546,-0.032939189
45027,7635,7246,15156,0.503760887,0.478094484,389,0.025666403,SC,Clarendon County,,15985,8967,6890,0.560963403,0.43102909,2077,0.129934313
45029,7616,9083,17231,0.44199408,0.527131333,1467,-0.085137253,SC,Colleton County,,17077,8470,8439,0.495988757,0.49417345,31,0.001815307
45031,13866,14973,29636,0.467876906,0.505230126,1107,-0.037353219,SC,Darlington County,,30140,15452,14429,0.512674187,0.478732581,1023,0.033941606
45033,5832,5637,11696,0.498632011,0.481959644,195,0.016672367,SC,Dillon County,,13186,7623,5477,0.57811315,0.415364781,2146,0.162748369
45035,24010,34932,62463,0.384387557,0.559243072,10922,-0.174855514,SC,Dorchester County,,56735,23390,32469,0.41226756,0.572292236,9079,-0.160024676
45037,4491,6842,11644,0.385692202,0.587598763,2351,-0.201906561,SC,Edgefield County,,11583,4965,6511,0.428645429,0.562116895,1546,-0.133471467
45039,6936,4024,11252,0.616423747,0.357625311,2912,0.258798436,SC,Fairfield County,,11858,7743,3996,0.652976893,0.336987688,3747,0.315989206
45041,26630,29498,57770,0.460965899,0.510611044,2868,-0.049645145,SC,Florence County,,57877,28508,28825,0.492561812,0.498038945,317,-0.005477133
45043,13234,17334,31519,0.419873727,0.549953996,4100,-0.130080269,SC,Georgetown County,,30870,14119,16476,0.457369615,0.53372206,2357,-0.076352446
45045,73338,125595,211572,0.34663377,0.593627701,52257,-0.246993931,SC,Greenville County,,191282,67378,120514,0.35224433,0.630033145,53136,-0.277788814
45047,10633,16881,28600,0.371783217,0.590244755,6248,-0.218461538,SC,Greenwood County,,28525,11884,16290,0.416617003,0.571078002,4406,-0.154460999
45049,5163,3483,8794,0.587104844,0.396065499,1680,0.191039345,SC,Hampton County,,9184,5814,3310,0.633057491,0.360409408,2504,0.272648084
45051,36731,83819,124503,0.295021004,0.673228758,47088,-0.378207754,SC,Horry County,,104584,36620,66653,0.350149162,0.637315459,30033,-0.287166297
45053,7789,6100,14216,0.54790377,0.429093979,1689,0.118809792,SC,Jasper County,,9991,5727,4169,0.573215894,0.417275548,1558,0.155940346
45055,10293,17464,28875,0.356467532,0.604813853,7171,-0.24834632,SC,Kershaw County,,27026,10821,15846,0.400392215,0.58632428,5025,-0.185932065
45057,13718,23598,38717,0.354314642,0.609499703,9880,-0.255185061,SC,Lancaster County,,33010,13345,19273,0.404271433,0.583853378,5928,-0.179581945
45059,8845,16770,26474,0.334101382,0.633451688,7925,-0.299350306,SC,Laurens County,,25373,10297,14726,0.40582509,0.58038072,4429,-0.17455563
45061,5170,2789,8110,0.637484587,0.343896424,2381,0.293588163,SC,Lee County,,8898,5972,2829,0.671162059,0.317936615,3143,0.353225444
45063,35143,79866,121829,0.288461696,0.6555582,44723,-0.367096504,SC,Lexington County,,112204,34007,76392,0.303081887,0.680831343,42385,-0.377749456
45065,2479,2651,5215,0.47535954,0.508341323,172,-0.032981783,SC,McCormick County,,5137,2637,2460,0.513334631,0.478878723,177,0.034455908
45067,8522,5434,14217,0.599423226,0.382218471,3088,0.217204755,SC,Marion County,,14766,9518,5114,0.64458892,0.346336178,4404,0.298252743
45069,5928,4257,10353,0.572587656,0.411185164,1671,0.161402492,SC,Marlboro County,,11657,7554,4010,0.648022647,0.343999314,3544,0.304023334
45071,6212,10011,16795,0.369871986,0.596070259,3799,-0.226198273,SC,Newberry County,,16287,6891,9218,0.423098176,0.565972862,2327,-0.142874685
45073,7979,24096,33530,0.237966001,0.718640024,16117,-0.480674023,SC,Oconee County,,30613,8537,21573,0.278868455,0.704700617,13036,-0.425832163
45075,26258,11909,38824,0.676334226,0.306743252,14349,0.369590975,SC,Orangeburg County,,42637,30454,11888,0.71426226,0.278818866,18566,0.435443394
45077,10327,36096,48871,0.211311412,0.738597532,25769,-0.527286121,SC,Pickens County,,45422,11122,33385,0.244859319,0.734996257,22263,-0.490136938
45079,108401,52753,169400,0.639911452,0.311410862,55648,0.32850059,SC,Richland County,,143016,94350,46725,0.659716395,0.326711697,47625,0.333004699
45081,2809,5525,8559,0.328192546,0.645519336,2716,-0.317326791,SC,Saluda County,,8553,3322,5130,0.38840173,0.599789548,1808,-0.211387817
45083,39888,76101,120793,0.330217811,0.630011673,36213,-0.299793862,SC,Spartanburg County,,108327,40920,65951,0.37774516,0.608814054,25031,-0.231068893
45085,24024,18733,44048,0.545405013,0.425286052,5291,0.120118961,SC,Sumter County,,47261,27550,19266,0.582933074,0.407651129,8284,0.175281945
45087,4727,7058,12087,0.391081327,0.583933151,2331,-0.192851824,SC,Union County,,12475,5748,6566,0.460761523,0.526332665,818,-0.065571142
45089,9949,4863,15049,0.66110705,0.323144395,5086,0.337962655,SC,Williamsburg County,,16282,11318,4819,0.695123449,0.295971011,6499,0.399152438
45091,41230,66245,113425,0.36350011,0.584042319,25015,-0.220542209,SC,York County,,99428,38757,59149,0.389799654,0.594892787,20392,-0.205093133
46003,340,974,1407,0.241648898,0.692253021,634,-0.450604122,SD,Aurora County,,1400,556,804,0.397142857,0.574285714,248,-0.177142857
46005,1912,4455,6772,0.282339043,0.657855877,2543,-0.375516834,SD,Beadle County,,7263,2881,4230,0.396668044,0.582403965,1349,-0.185735922
46007,412,666,1149,0.358572672,0.579634465,254,-0.221061793,SD,Bennett County,,1203,548,626,0.455527847,0.520365752,78,-0.064837905
46009,704,2105,2974,0.236718225,0.707800941,1401,-0.471082717,SD,Bon Homme County,,3074,1167,1830,0.379635654,0.59531555,663,-0.215679896
46011,4879,6748,12680,0.38477918,0.532176656,1869,-0.147397476,SD,Brookings County,,12398,5826,6219,0.469914502,0.501613163,393,-0.031698661
46013,5452,9613,16113,0.33836033,0.596599019,4161,-0.258238689,SD,Brown County,,16066,7249,8320,0.451201295,0.517863812,1071,-0.066662517
46015,571,1565,2288,0.249562937,0.684003497,994,-0.434440559,SD,Brule County,,2379,824,1499,0.346364018,0.630096679,675,-0.283732661
46017,296,171,490,0.604081633,0.348979592,125,0.255102041,SD,Buffalo County,,641,472,166,0.736349454,0.258970359,306,0.477379095
46019,693,3355,4346,0.159456972,0.771974229,2662,-0.612517257,SD,Butte County,,4201,1000,3068,0.238038562,0.730302309,2068,-0.492263747
46021,105,704,831,0.126353791,0.847172082,599,-0.720818291,SD,Campbell County,,787,153,616,0.194409149,0.782719187,463,-0.588310038
46023,935,2382,3433,0.272356539,0.693853772,1447,-0.421497233,SD,Charles Mix County,,3762,1482,2229,0.393939394,0.592503987,747,-0.198564593
46025,398,1139,1657,0.24019312,0.687386844,741,-0.447193724,SD,Clark County,,1821,713,1067,0.391543108,0.58594179,354,-0.194398682
46027,2608,2109,5069,0.514499901,0.416058394,499,0.098441507,SD,Clay County,,5233,2955,2146,0.564685649,0.410089815,809,0.154595834
46029,3174,7764,11669,0.272002742,0.665352644,4590,-0.393349901,SD,Codington County,,11524,4588,6696,0.398125651,0.581048247,2108,-0.182922596
46031,535,588,1175,0.455319149,0.500425532,53,-0.045106383,SD,Corson County,,1199,647,515,0.539616347,0.429524604,132,0.110091743
46033,1120,3290,4716,0.237489398,0.697625106,2170,-0.460135708,SD,Custer County,,4520,1335,3062,0.295353982,0.677433628,1727,-0.382079646
46035,2355,5157,7952,0.296151911,0.648516097,2802,-0.352364185,SD,Davison County,,7968,3042,4754,0.381777108,0.596636546,1712,-0.214859438
46037,974,1627,2747,0.35456862,0.59228249,653,-0.23771387,SD,Day County,,2873,1497,1320,0.521058127,0.459450052,177,0.061608075
46039,570,1366,2080,0.274038462,0.656730769,796,-0.382692308,SD,Deuel County,,2171,941,1175,0.433440811,0.541225242,234,-0.107784431
46041,887,723,1707,0.519625073,0.423550088,164,0.096074985,SD,Dewey County,,1895,1207,663,0.636939314,0.349868074,544,0.28707124
46043,214,1338,1605,0.133333333,0.83364486,1124,-0.700311526,SD,Douglas County,,1690,332,1334,0.196449704,0.789349112,1002,-0.592899408
46045,380,1433,1918,0.198123045,0.74713243,1053,-0.549009385,SD,Edmunds County,,1936,622,1264,0.321280992,0.652892562,642,-0.33161157
46047,821,2511,3563,0.2304238,0.704743194,1690,-0.474319394,SD,Fall River County,,3511,1137,2256,0.323839362,0.642551979,1119,-0.318712617
46049,204,858,1118,0.182468694,0.76744186,654,-0.584973166,SD,Faulk County,,1127,331,765,0.293700089,0.678793256,434,-0.385093168
46051,970,2381,3562,0.272318922,0.668444694,1411,-0.396125772,SD,Grant County,,3606,1493,2034,0.414032169,0.5640599,541,-0.150027732
46053,391,1600,2091,0.18699187,0.765184122,1209,-0.578192253,SD,Gregory County,,2151,599,1507,0.278475128,0.70060437,908,-0.422129242
46055,77,936,1044,0.073754789,0.896551724,859,-0.822796935,SD,Haakon County,,1092,138,940,0.126373626,0.860805861,802,-0.734432234
46057,555,2051,2762,0.200941347,0.742577842,1496,-0.541636495,SD,Hamlin County,,2793,921,1803,0.329752954,0.645542427,882,-0.315789474
46059,334,1391,1818,0.183718372,0.765126513,1057,-0.581408141,SD,Hand County,,1848,575,1242,0.311147186,0.672077922,667,-0.360930736
46061,424,1497,2006,0.211365902,0.746261216,1073,-0.534895314,SD,Hanson County,,2416,760,1627,0.314569536,0.673427152,867,-0.358857616
46063,38,694,769,0.049414824,0.902470741,656,-0.853055917,SD,Harding County,,739,82,638,0.110960758,0.863328823,556,-0.752368065
46065,2449,5174,8173,0.299645173,0.633060076,2725,-0.333414903,SD,Hughes County,,8155,2786,5219,0.341630901,0.639975475,2433,-0.298344574
46067,692,2517,3365,0.20564636,0.747994056,1825,-0.542347697,SD,Hutchinson County,,3425,923,2451,0.269489051,0.715620438,1528,-0.446131387
46069,125,543,690,0.18115942,0.786956522,418,-0.605797101,SD,Hyde County,,733,189,531,0.257844475,0.724420191,342,-0.466575716
46071,323,722,1095,0.294977169,0.659360731,399,-0.364383562,SD,Jackson County,,1106,426,661,0.38517179,0.597649186,235,-0.212477396
46073,264,648,967,0.273009307,0.670113754,384,-0.397104447,SD,Jerauld County,,1006,452,538,0.449304175,0.534791252,86,-0.085487078
46075,69,450,558,0.123655914,0.806451613,381,-0.682795699,SD,Jones County,,609,108,490,0.177339901,0.804597701,382,-0.6272578
46077,703,1680,2551,0.275578205,0.658565269,977,-0.382987064,SD,Kingsbury County,,2608,1092,1451,0.418711656,0.556365031,359,-0.137653374
46079,2314,4038,6786,0.340996169,0.59504863,1724,-0.254052461,SD,Lake County,,6285,2724,3419,0.433412888,0.543993636,695,-0.110580748
46081,3356,7411,11842,0.283398075,0.625823341,4055,-0.342425266,SD,Lawrence County,,11359,3973,7025,0.349766705,0.618452329,3052,-0.268685624
46083,8076,15499,25231,0.320082438,0.614284016,7423,-0.294201577,SD,Lincoln County,,21952,7982,13611,0.363611516,0.620034621,5629,-0.256423105
46085,369,977,1421,0.259676284,0.687543983,608,-0.427867699,SD,Lyman County,,1569,605,933,0.385595921,0.594646272,328,-0.209050351
46087,623,1794,2587,0.240819482,0.693467337,1171,-0.452647855,SD,McCook County,,2613,905,1655,0.346345197,0.633371604,750,-0.287026406
46089,192,892,1137,0.168865435,0.784520668,700,-0.615655233,SD,McPherson County,,1215,272,921,0.223868313,0.758024691,649,-0.534156379
46091,754,1056,1947,0.387262455,0.542372881,302,-0.155110426,SD,Marshall County,,1987,1061,889,0.53397081,0.447408153,172,0.086562657
46093,2223,8441,11621,0.191291627,0.726357456,6218,-0.535065829,SD,Meade County,,10811,2928,7560,0.27083526,0.699287762,4632,-0.428452502
46095,238,402,683,0.348462665,0.588579795,164,-0.24011713,SD,Mellette County,,769,375,381,0.487646294,0.495448635,6,-0.007802341
46097,281,706,1064,0.264097744,0.663533835,425,-0.39943609,SD,Miner County,,1140,479,636,0.420175439,0.557894737,157,-0.137719298
46099,30610,42043,78263,0.391117131,0.537201487,11433,-0.146084357,SD,Minnehaha County,,76565,34668,40330,0.452791746,0.526741984,5662,-0.073950238
46101,1042,1729,2930,0.355631399,0.590102389,687,-0.23447099,SD,Moody County,,3033,1429,1535,0.471150676,0.506099571,106,-0.034948895
46103,14074,29804,47741,0.29479902,0.624285206,15730,-0.329486186,SD,Pennington County,,44458,15122,28229,0.340141257,0.634958838,13107,-0.294817581
46105,188,1333,1606,0.117061021,0.830012453,1145,-0.712951432,SD,Perkins County,,1590,319,1205,0.200628931,0.757861635,886,-0.557232704
46107,215,1069,1335,0.161048689,0.800749064,854,-0.639700375,SD,Potter County,,1381,339,1029,0.245474294,0.745112238,690,-0.499637944
46109,1539,2142,3886,0.396037056,0.55120947,603,-0.155172414,SD,Roberts County,,4256,2302,1883,0.540883459,0.442434211,419,0.098449248
46111,241,819,1123,0.21460374,0.729296527,578,-0.514692787,SD,Sanborn County,,1115,389,688,0.348878924,0.617040359,299,-0.268161435
46113,2504,241,2896,0.864640884,0.083218232,2263,0.781422652,SD,Oglala County,,3130,2922,188,0.933546326,0.060063898,2734,0.873482428
46115,919,1854,2951,0.311419858,0.628261606,935,-0.316841749,SD,Spink County,,3041,1300,1670,0.427490957,0.54916146,370,-0.121670503
46117,329,1148,1567,0.209955329,0.732610083,819,-0.522654754,SD,Stanley County,,1540,435,1063,0.282467532,0.69025974,628,-0.407792208
46119,137,679,861,0.159117305,0.788617886,542,-0.629500581,SD,Sully County,,816,186,611,0.227941176,0.74877451,425,-0.520833333
46121,1505,487,2125,0.708235294,0.229176471,1018,0.479058824,SD,Todd County,,2497,1976,498,0.79134962,0.199439327,1478,0.591910292
46123,462,2069,2630,0.175665399,0.786692015,1607,-0.611026616,SD,Tripp County,,2691,737,1905,0.273875883,0.707915273,1168,-0.434039391
46125,961,2937,4150,0.231566265,0.707710843,1976,-0.476144578,SD,Turner County,,4210,1411,2715,0.335154394,0.644893112,1304,-0.309738717
46127,2227,5288,7895,0.282077264,0.669791007,3061,-0.387713743,SD,Union County,,7596,2782,4698,0.366245392,0.618483412,1916,-0.25223802
46129,457,1896,2477,0.184497376,0.765442067,1439,-0.580944691,SD,Walworth County,,2462,671,1731,0.272542648,0.703086921,1060,-0.430544273
46135,3301,5654,9616,0.34328203,0.587978369,2353,-0.244696339,SD,Yankton County,,9924,4208,5463,0.424022572,0.550483676,1255,-0.126461104
46137,352,368,766,0.459530026,0.480417755,16,-0.020887728,SD,Ziebach County,,761,439,314,0.576872536,0.41261498,125,0.164257556
47001,9010,19201,29723,0.303132254,0.645998049,10191,-0.342865794,TN,Anderson County,,29621,10112,18941,0.341379427,0.639444988,8829,-0.298065562
47003,3384,11455,15300,0.221176471,0.74869281,8071,-0.52751634,TN,Bedford County,,14433,4207,10026,0.291484792,0.694658075,5819,-0.403173283
47005,1474,4715,6322,0.233154065,0.745808289,3241,-0.512654223,TN,Benton County,,6223,2255,3850,0.362365419,0.618672666,1595,-0.256307247
47007,896,3621,4650,0.192688172,0.778709677,2725,-0.586021505,TN,Bledsoe County,,4359,1267,3022,0.290662996,0.693278275,1755,-0.402615279
47009,12085,37385,51849,0.233080677,0.721036086,25300,-0.487955409,TN,Blount County,,49200,12925,35417,0.262703252,0.719857724,22492,-0.457154472
47011,7070,29761,38392,0.184152949,0.775187539,22691,-0.591034591,TN,Bradley County,,35956,8035,27417,0.223467571,0.762515296,19382,-0.539047725
47013,2248,9860,12504,0.17978247,0.788547665,7612,-0.608765195,TN,Campbell County,,12097,3327,8602,0.275026866,0.711085393,5275,-0.436058527
47015,1126,4006,5299,0.212492923,0.755991697,2880,-0.543498773,TN,Cannon County,,4968,1560,3308,0.314009662,0.665861514,1748,-0.351851852
47017,2323,7731,10333,0.224813704,0.748185425,5408,-0.523371722,TN,Carroll County,,10845,3475,7219,0.320424159,0.665652374,3744,-0.345228216
47019,3453,16897,20993,0.164483399,0.804887343,13444,-0.640403944,TN,Carter County,,20607,4786,15496,0.232251177,0.751977483,10710,-0.519726307
47021,3877,11295,15823,0.245023068,0.713834292,7418,-0.468811224,TN,Cheatham County,,15177,4656,10266,0.306779996,0.676418264,5610,-0.369638268
47023,902,3827,4850,0.185979381,0.789072165,2925,-0.603092784,TN,Chester County,,6396,1622,4672,0.253595997,0.730456535,3050,-0.476860538
47025,1831,8589,10706,0.171025593,0.802260415,6758,-0.631234822,TN,Claiborne County,,10178,2433,7617,0.239044999,0.748378856,5184,-0.509333857
47027,707,2140,2919,0.242206235,0.733127783,1433,-0.490921548,TN,Clay County,,2820,1037,1747,0.367730496,0.619503546,710,-0.25177305
47029,1980,9791,12108,0.163528246,0.808638916,7811,-0.645110671,TN,Cocke County,,11450,2804,8459,0.24489083,0.738777293,5655,-0.493886463
47031,4741,14409,19895,0.238301081,0.724252325,9668,-0.485951244,TN,Coffee County,,19242,5865,13013,0.304801996,0.676281052,7148,-0.371479056
47033,1302,3977,5386,0.241737839,0.738395841,2675,-0.496658002,TN,Crockett County,,5497,1669,3782,0.303620156,0.688011643,2113,-0.384391486
47035,5202,20410,26298,0.197809719,0.776104647,15208,-0.578294927,TN,Cumberland County,,25244,6260,18651,0.247979718,0.738829029,12391,-0.490849311
47037,148473,84365,246199,0.603060939,0.342669954,64108,0.260390985,TN,Davidson County,,237372,138899,94464,0.585153262,0.397957636,44435,0.187195625
47039,894,3580,4577,0.195324448,0.782171728,2686,-0.58684728,TN,Decatur County,,4248,1302,2873,0.306497175,0.676318267,1571,-0.369821092
47041,1566,5164,6940,0.225648415,0.744092219,3598,-0.518443804,TN,DeKalb County,,6406,2168,4134,0.338432719,0.645332501,1966,-0.306899781
47043,4718,13213,18619,0.253397068,0.709651431,8495,-0.456254364,TN,Dickson County,,17821,6228,11287,0.349475338,0.633353908,5059,-0.28387857
47045,2815,10175,13290,0.211813394,0.765613243,7360,-0.55379985,TN,Dyer County,,13800,3757,9921,0.272246377,0.718913043,6164,-0.446666667
47047,5865,13046,19306,0.303791567,0.675748472,7181,-0.371956905,TN,Fayette County,,19562,6683,12682,0.341631735,0.64829772,5999,-0.306665985
47049,1100,6032,7311,0.150458214,0.825058132,4932,-0.674599918,TN,Fentress County,,6890,1559,5240,0.226269956,0.760522496,3681,-0.53425254
47051,4372,11526,16363,0.267188168,0.70439406,7154,-0.437205891,TN,Franklin County,,16099,5594,10252,0.347474998,0.63680974,4658,-0.289334741
47053,5255,13779,19484,0.269708479,0.707195648,8524,-0.437487169,TN,Gibson County,,19667,6564,12883,0.333757055,0.655056694,6319,-0.321299639
47055,2915,7964,11120,0.262140288,0.71618705,5049,-0.454046763,TN,Giles County,,10797,3759,6914,0.348152265,0.640363064,3155,-0.292210799
47057,1154,6618,7985,0.144520977,0.828804008,5464,-0.684283031,TN,Grainger County,,7250,1668,5469,0.230068966,0.754344828,3801,-0.524275862
47059,4211,18538,23491,0.179260142,0.789153293,14327,-0.609893151,TN,Greene County,,23937,6216,17234,0.259681664,0.719973263,11018,-0.460291599
47061,998,3626,4750,0.210105263,0.763368421,2628,-0.553263158,TN,Grundy County,,4217,1637,2502,0.388190657,0.593312782,865,-0.205122125
47063,4075,15839,20579,0.198017396,0.769668108,11764,-0.571650712,TN,Hamblen County,,20020,5229,14515,0.261188811,0.725024975,9286,-0.463836164
47065,55260,78661,141088,0.391670447,0.55753147,23401,-0.165861023,TN,Hamilton County,,142320,58794,79877,0.413111298,0.561249297,21083,-0.148137999
47067,322,1842,2229,0.144459399,0.826379542,1520,-0.681920144,TN,Hancock County,,2046,475,1527,0.232160313,0.746334311,1052,-0.514173998
47069,4174,4912,9242,0.451633845,0.531486691,738,-0.079852846,TN,Hardeman County,,10435,5479,4864,0.525059895,0.466123622,615,0.058936272
47071,1622,8012,9949,0.16303146,0.805307066,6390,-0.642275606,TN,Hardin County,,10495,2467,7886,0.235064316,0.751405431,5419,-0.516341115
47073,3502,16611,20694,0.169227795,0.802696434,13109,-0.633468638,TN,Hawkins County,,19789,5086,14376,0.257011471,0.726464197,9290,-0.469452726
47075,3704,3010,6824,0.542790152,0.44109027,694,0.101699883,TN,Haywood County,,7567,4567,2960,0.603541694,0.391172195,1607,0.212369499
47077,1796,8118,10172,0.176563114,0.798073142,6322,-0.621510028,TN,Henderson County,,10051,2516,7418,0.250323351,0.738036016,4902,-0.487712665
47079,3061,9483,12887,0.237526189,0.735857841,6422,-0.498331652,TN,Henry County,,12731,4337,8187,0.34066452,0.643075956,3850,-0.302411437
47081,1823,5685,7762,0.234862149,0.732414326,3862,-0.497552177,TN,Hickman County,,7595,2693,4756,0.354575379,0.626201448,2063,-0.27162607
47083,865,2180,3165,0.273301738,0.68878357,1315,-0.415481833,TN,Houston County,,3027,1400,1579,0.46250413,0.521638586,179,-0.059134457
47085,1967,4928,7139,0.275528786,0.690292758,2961,-0.414763973,TN,Humphreys County,,6860,2904,3829,0.423323615,0.558163265,925,-0.13483965
47087,1129,3229,4447,0.25387902,0.726107488,2100,-0.472228469,TN,Jackson County,,4178,1736,2380,0.415509813,0.569650551,644,-0.154140737
47089,3490,14760,18994,0.183742234,0.777087501,11270,-0.593345267,TN,Jefferson County,,17565,4230,13037,0.240819812,0.742214631,8807,-0.501394819
47091,988,5400,6556,0.150701647,0.823672971,4412,-0.672971324,TN,Johnson County,,6194,1483,4611,0.23942525,0.744430094,3128,-0.505004843
47093,62861,105724,179266,0.350657682,0.589760468,42863,-0.239102786,TN,Knox County,,167330,57594,106411,0.344194107,0.635934979,48817,-0.291740871
47095,577,1357,1970,0.292893401,0.688832487,780,-0.395939086,TN,Lake County,,2087,884,1163,0.423574509,0.557259224,279,-0.133684715
47097,3656,4884,8678,0.421295229,0.562802489,1228,-0.14150726,TN,Lauderdale County,,8688,4010,4616,0.461556169,0.531307551,606,-0.069751381
47099,2821,12419,15658,0.180163495,0.793140886,9598,-0.612977392,TN,Lawrence County,,15219,4237,10770,0.278401998,0.707668047,6533,-0.429266049
47101,890,3579,4601,0.19343621,0.777874375,2689,-0.584438166,TN,Lewis County,,4691,1445,3116,0.308036666,0.664250693,1671,-0.356214027
47103,2550,10375,13270,0.192162773,0.781838734,7825,-0.589675961,TN,Lincoln County,,13249,3283,9791,0.247792286,0.73899917,6508,-0.491206884
47105,4916,17588,23304,0.21095091,0.75472022,12672,-0.54376931,TN,Loudon County,,22066,5057,16701,0.229176108,0.756865766,11644,-0.527689658
47107,3507,14673,18694,0.1876003,0.784904247,11166,-0.597303948,TN,McMinn County,,17818,4603,12958,0.258334269,0.727242115,8355,-0.468907846
47109,1847,7839,10035,0.184055805,0.781165919,5992,-0.597110115,TN,McNairy County,,9809,2643,7010,0.269446427,0.714649811,4367,-0.445203385
47111,1071,6260,7490,0.142990654,0.835781041,5189,-0.692790387,TN,Macon County,,6904,1552,5259,0.224797219,0.761732329,3707,-0.53693511
47113,15438,21321,37764,0.408802034,0.564585319,5883,-0.155783286,TN,Madison County,,40691,18360,21989,0.451205426,0.540389767,3629,-0.089184341
47115,2829,7680,10832,0.261170606,0.70901034,4851,-0.447839734,TN,Marion County,,10404,3952,6268,0.379853902,0.602460592,2316,-0.22260669
47117,2848,8167,11402,0.24978074,0.716277846,5319,-0.466497106,TN,Marshall County,,10729,3722,6823,0.346910243,0.635939976,3101,-0.289029733
47119,10026,23781,35068,0.285901677,0.678139614,13755,-0.392237938,TN,Maury County,,32989,11819,20698,0.358270939,0.627421262,8879,-0.269150323
47121,856,3337,4311,0.198561819,0.774066342,2481,-0.575504523,TN,Meigs County,,3958,1163,2728,0.29383527,0.689236988,1565,-0.395401718
47123,3184,13361,17050,0.186744868,0.783636364,10177,-0.596891496,TN,Monroe County,,16320,4368,11717,0.267647059,0.717953431,7349,-0.450306373
47125,21686,32320,57278,0.378609588,0.564265512,10634,-0.185655924,TN,Montgomery County,,55424,24349,30159,0.439322315,0.544150548,5810,-0.104828233
47127,496,2325,2926,0.169514696,0.794600137,1829,-0.625085441,TN,Moore County,,2799,705,2053,0.25187567,0.733476242,1348,-0.481600572
47129,1053,5429,6664,0.158013205,0.81467587,4376,-0.656662665,TN,Morgan County,,6500,1722,4668,0.264923077,0.718153846,2946,-0.453230769
47131,2425,9525,12223,0.198396466,0.779268592,7100,-0.580872126,TN,Obion County,,12296,3320,8814,0.270006506,0.716818478,5494,-0.446811971
47133,1943,6055,8195,0.23709579,0.738865162,4112,-0.501769372,TN,Overton County,,7657,2802,4772,0.365939663,0.623220582,1970,-0.257280919
47135,597,2167,2855,0.20910683,0.759019264,1570,-0.549912434,TN,Perry County,,2621,992,1578,0.378481496,0.602060282,586,-0.223578787
47137,536,2019,2609,0.205442698,0.773859716,1483,-0.568417018,TN,Pickett County,,2446,711,1707,0.290678659,0.69787408,996,-0.407195421
47139,1252,5097,6520,0.19202454,0.781748466,3845,-0.589723926,TN,Polk County,,6059,1856,4108,0.306321175,0.67799967,2252,-0.371678495
47141,6847,18981,26958,0.253987685,0.704095259,12134,-0.450107575,TN,Putnam County,,25479,7793,17242,0.305859728,0.676714157,9449,-0.370854429
47143,1942,8650,10946,0.177416408,0.790243011,6708,-0.612826603,TN,Rhea County,,10578,2625,7793,0.248156551,0.736717716,5168,-0.488561165
47145,4833,15863,21580,0.223957368,0.735078777,11030,-0.511121409,TN,Roane County,,21081,6014,14719,0.285280584,0.69821166,8705,-0.412931075
47147,6634,19393,27042,0.245322092,0.717143702,12759,-0.471821611,TN,Robertson County,,26285,8289,17641,0.315350961,0.671143238,9352,-0.355792277
47149,36627,64428,106518,0.343857376,0.604855517,27801,-0.260998141,TN,Rutherford County,,98816,36400,60829,0.368361399,0.615578449,24429,-0.24721705
47151,934,6044,7123,0.131124526,0.848518882,5110,-0.717394356,TN,Scott County,,6668,1452,5117,0.217756449,0.767396521,3665,-0.549640072
47153,1051,4434,5667,0.185459679,0.782424563,3383,-0.596964884,TN,Sequatchie County,,5141,1488,3541,0.289437853,0.688776503,2053,-0.39933865
47155,6293,28610,36180,0.173935876,0.79076838,22317,-0.616832504,TN,Sevier County,,33856,7415,25979,0.219015832,0.767338138,18564,-0.548322306
47157,206640,114948,331861,0.622670335,0.346373934,91692,0.276296401,TN,Shelby County,,370749,232201,135536,0.626302431,0.365573474,96665,0.260728957
47159,1688,5485,7410,0.22780027,0.740215924,3797,-0.512415655,TN,Smith County,,7081,2467,4492,0.348397119,0.634373676,2025,-0.285976557
47161,1222,3864,5283,0.231307969,0.731402612,2642,-0.500094643,TN,Stewart County,,5115,2069,2963,0.404496579,0.579276637,894,-0.174780059
47163,11910,45577,59860,0.19896425,0.761393251,33667,-0.562429001,TN,Sullivan County,,59833,15303,43528,0.255761871,0.727491518,28225,-0.471729648
47165,18153,50105,71080,0.255388295,0.704909961,31952,-0.449521666,TN,Sumner County,,65334,18571,45979,0.2842471,0.703753023,27408,-0.419505923
47167,5779,16893,23372,0.247261681,0.722787951,11114,-0.475526271,TN,Tipton County,,23682,7020,16395,0.296427667,0.692297948,9375,-0.395870281
47169,943,2099,3142,0.300127307,0.668045831,1156,-0.367918523,TN,Trousdale County,,2901,1238,1610,0.426749397,0.554981041,372,-0.128231644
47171,1260,5666,7166,0.17583031,0.790678203,4406,-0.614847893,TN,Unicoi County,,7078,1909,5028,0.269708957,0.710370161,3119,-0.440661204
47173,1010,5024,6204,0.162798195,0.809800129,4014,-0.647001934,TN,Union County,,5820,1474,4278,0.253264605,0.735051546,2804,-0.481786942
47175,539,1820,2417,0.223003724,0.752999586,1281,-0.529995863,TN,Van Buren County,,2298,875,1384,0.380765883,0.602262837,509,-0.221496954
47177,3535,9535,13565,0.260597125,0.702911906,6000,-0.442314781,TN,Warren County,,13008,4748,8007,0.36500615,0.61554428,3259,-0.25053813
47179,13003,34179,49411,0.263160025,0.691728562,21176,-0.428568537,TN,Washington County,,48003,14318,32787,0.298273025,0.683019811,18469,-0.384746787
47181,717,5034,5842,0.122731941,0.861691202,4317,-0.738959261,TN,Wayne County,,5484,1163,4251,0.212071481,0.775164114,3088,-0.563092633
47183,2770,9001,12127,0.228415931,0.742228086,6231,-0.513812155,TN,Weakley County,,12332,3547,8601,0.287625689,0.697453779,5054,-0.40982809
47185,1842,7657,9776,0.188420622,0.783244681,5815,-0.594824059,TN,White County,,9133,2793,6192,0.305814081,0.677980948,3399,-0.372166867
47187,30992,68160,104700,0.296007641,0.651002865,37168,-0.354995224,TN,Williamson County,,93606,24328,68090,0.25989787,0.727410636,43762,-0.467512766
47189,14356,39304,56286,0.255054543,0.698290872,24948,-0.443236329,TN,Wilson County,,51437,14669,36076,0.285183817,0.701362832,21407,-0.416179015
48001,3358,13165,16887,0.198851187,0.77959377,9807,-0.580742583,TX,Anderson County,,16167,3796,12235,0.234799282,0.75678852,8439,-0.521989237
48003,836,3925,4926,0.169711734,0.796792529,3089,-0.627080796,TX,Andrews County,,4476,794,3636,0.177390527,0.81233244,2842,-0.634941912
48005,7538,21666,29870,0.252360228,0.725343154,14128,-0.472982926,TX,Angelina County,,28403,7833,20301,0.275780727,0.714748442,12468,-0.438967715
48007,2458,7730,10467,0.234833286,0.738511512,5272,-0.503678227,TX,Aransas County,,9646,2703,6829,0.28021978,0.707961849,4126,-0.427742069
48009,394,3785,4269,0.092293277,0.886624502,3391,-0.794331225,TX,Archer County,,4163,525,3599,0.126110978,0.864520778,3074,-0.738409801
48011,70,924,1017,0.068829892,0.908554572,854,-0.83972468,TX,Armstrong County,,935,98,828,0.104812834,0.885561497,730,-0.780748663
48013,4635,8598,13605,0.340683572,0.631973539,3963,-0.291289967,TX,Atascosa County,,12704,5128,7451,0.403652393,0.586508186,2323,-0.182855793
48015,2319,9637,12255,0.189228886,0.786372909,7318,-0.597144023,TX,Austin County,,11628,2252,9260,0.193670451,0.796353629,7008,-0.602683179
48017,397,1343,1784,0.222533632,0.752802691,946,-0.530269058,TX,Bailey County,,1813,466,1336,0.257032543,0.736900165,870,-0.479867623
48019,1726,8159,10213,0.169000294,0.798883776,6433,-0.629883482,TX,Bandera County,,9434,1859,7423,0.197053212,0.786834853,5564,-0.589781641
48021,10555,16314,28250,0.373628319,0.577486726,5759,-0.203858407,TX,Bastrop County,,24457,9860,14019,0.40315656,0.573210124,4159,-0.170053563
48023,191,1267,1492,0.128016086,0.84919571,1076,-0.721179625,TX,Baylor County,,1592,267,1297,0.167713568,0.814698492,1030,-0.646984925
48025,3443,4743,8458,0.407070229,0.560770868,1300,-0.153700638,TX,Bee County,,7873,3451,4354,0.438333545,0.553029341,903,-0.114695796
48027,37608,51780,93999,0.400089363,0.550856924,14172,-0.150767561,TX,Bell County,,85765,35315,49369,0.411764706,0.575631085,14054,-0.163866379
48029,319191,240161,586038,0.54465922,0.409804484,79030,0.134854736,TX,Bexar County,,511405,263871,240519,0.515972664,0.470310224,23352,0.04566244
48031,1244,4212,5669,0.219439055,0.742988181,2968,-0.523549127,TX,Blanco County,,4971,1220,3637,0.245423456,0.731643532,2417,-0.486220076
48033,31,330,365,0.084931507,0.904109589,299,-0.819178082,TX,Borden County,,362,32,324,0.08839779,0.895027624,292,-0.806629834
48035,1277,6325,7797,0.163780941,0.81120944,5048,-0.647428498,TX,Bosque County,,7336,1366,5873,0.186205016,0.800572519,4507,-0.614367503
48037,8831,24913,34470,0.256193792,0.722744415,16082,-0.466550624,TX,Bowie County,,35357,10184,24840,0.288033487,0.702548293,14656,-0.414514806
48039,43075,72653,120296,0.358075081,0.603951919,29578,-0.245876837,TX,Brazoria County,,106422,34327,70684,0.322555487,0.664185977,36357,-0.34163049
48041,23041,38662,66036,0.348915743,0.585468532,15621,-0.236552789,TX,Brazos County,,55845,17440,37152,0.312292954,0.665269944,19712,-0.35297699
48043,1869,2073,4226,0.442262186,0.490534785,204,-0.048272598,TX,Brewster County,,3866,1765,1975,0.456544232,0.510863942,210,-0.05431971
48045,91,625,734,0.123978202,0.851498638,534,-0.727520436,TX,Briscoe County,,700,117,576,0.167142857,0.822857143,459,-0.655714286
48047,1937,613,2596,0.74614792,0.236132512,1324,0.510015408,TX,Brooks County,,2403,1886,507,0.784852268,0.210986267,1379,0.573866001
48049,1621,12010,13949,0.116209047,0.86099362,10389,-0.744784572,TX,Brown County,,13936,1904,11894,0.136624569,0.85347302,9990,-0.71684845
48051,1491,5316,6945,0.214686825,0.765442765,3825,-0.55075594,TX,Burleson County,,6455,1705,4671,0.264136328,0.723625097,2966,-0.459488768
48053,3785,14595,19046,0.198729392,0.766302636,10810,-0.567573244,TX,Burnet County,,16770,3672,12828,0.218962433,0.764937388,9156,-0.545974955
48055,4663,6516,11709,0.39824067,0.556495004,1853,-0.158254334,TX,Caldwell County,,11055,4787,6018,0.433016735,0.544369064,1231,-0.111352329
48057,2118,4638,6957,0.30444157,0.666666667,2520,-0.362225097,TX,Calhoun County,,6746,2510,4145,0.372072339,0.614438186,1635,-0.242365846
48059,568,4858,5556,0.102231821,0.87437005,4290,-0.772138229,TX,Callahan County,,5195,751,4376,0.144562079,0.842348412,3625,-0.697786333
48061,59319,29432,91804,0.646148316,0.320596052,29887,0.325552264,TX,Cameron County,,74802,49159,24955,0.65718831,0.333614074,24204,0.323574236
48063,1260,3201,4542,0.277410832,0.704755614,1941,-0.427344782,TX,Camp County,,4332,1428,2878,0.329639889,0.664358264,1450,-0.334718375
48065,249,2617,2945,0.084550085,0.888624788,2368,-0.804074703,TX,Carson County,,2775,292,2450,0.105225225,0.882882883,2158,-0.777657658
48067,2250,9182,11606,0.193865242,0.791142512,6932,-0.59727727,TX,Cass County,,11764,2921,8747,0.248299898,0.743539612,5826,-0.495239714
48069,526,1413,1996,0.263527054,0.707915832,887,-0.444388778,TX,Castro County,,2119,630,1470,0.297310052,0.693723454,840,-0.396413403
48071,2939,13278,16661,0.176399976,0.796950963,10339,-0.620550987,TX,Chambers County,,14692,2780,11761,0.189218622,0.800503675,8981,-0.611285053
48073,3466,12896,16701,0.207532483,0.772169331,9430,-0.564636848,TX,Cherokee County,,16387,3935,12291,0.240129371,0.750045768,8356,-0.509916397
48075,253,1802,2084,0.121401152,0.864683301,1549,-0.74328215,TX,Childress County,,1996,320,1665,0.160320641,0.834168337,1345,-0.673847695
48077,536,4376,5011,0.106964678,0.873278787,3840,-0.766314109,TX,Clay County,,5056,740,4266,0.146360759,0.84375,3526,-0.697389241
48079,190,679,901,0.210876804,0.753607103,489,-0.5427303,TX,Cochran County,,916,256,648,0.279475983,0.707423581,392,-0.427947598
48081,140,1265,1423,0.098383696,0.888966971,1125,-0.790583275,TX,Coke County,,1406,179,1216,0.127311522,0.864864865,1037,-0.737553343
48083,387,3177,3635,0.106464924,0.874002751,2790,-0.767537827,TX,Coleman County,,3483,441,3007,0.126614987,0.863336204,2566,-0.736721217
48085,139837,200395,356545,0.392200143,0.562046866,60558,-0.169846723,TX,Collin County,,301101,100754,195933,0.334618616,0.650721851,95179,-0.316103234
48087,145,983,1154,0.125649913,0.851819757,838,-0.726169844,TX,Collingsworth County,,1150,177,962,0.153913043,0.836521739,785,-0.682608696
48089,1977,6323,8480,0.233136792,0.745636792,4346,-0.5125,TX,Colorado County,,8095,2024,6015,0.250030883,0.743051266,3991,-0.493020383
48091,14166,44996,61567,0.230090795,0.73084607,30830,-0.500755275,TX,Comal County,,51475,11437,39291,0.222185527,0.763302574,27854,-0.541117047
48093,788,4300,5208,0.151305684,0.825652842,3512,-0.674347158,TX,Comanche County,,4897,890,3940,0.181743925,0.804574229,3050,-0.622830304
48095,148,885,1067,0.138706654,0.829428304,737,-0.690721649,TX,Concho County,,1001,194,793,0.193806194,0.792207792,599,-0.598401598
48097,2345,13174,15894,0.147539952,0.828866239,10829,-0.681326287,TX,Cooke County,,14291,2240,11901,0.156742005,0.832761878,9661,-0.676019873
48099,5057,12212,18127,0.278976113,0.673691179,7155,-0.394715066,TX,Coryell County,,16551,5141,11193,0.310615673,0.676273337,6052,-0.365657664
48101,84,486,583,0.144082333,0.833619211,402,-0.689536878,TX,Cottle County,,739,180,553,0.243572395,0.748308525,373,-0.50473613
48103,299,1047,1381,0.216509776,0.758146271,748,-0.541636495,TX,Crane County,,1283,275,985,0.214341387,0.767731878,710,-0.553390491
48105,372,980,1395,0.266666667,0.702508961,608,-0.435842294,TX,Crockett County,,1457,480,957,0.329444063,0.656829101,477,-0.327385038
48107,468,1180,1712,0.273364486,0.689252336,712,-0.41588785,TX,Crosby County,,1787,639,1132,0.357582541,0.633463906,493,-0.275881365
48109,454,280,762,0.595800525,0.367454068,174,0.228346457,TX,Culberson County,,876,566,294,0.646118721,0.335616438,272,0.310502283
48111,222,1258,1535,0.144625407,0.819543974,1036,-0.674918567,TX,Dallam County,,1532,253,1248,0.165143603,0.81462141,995,-0.649477807
48113,458845,261865,750649,0.611264386,0.348851461,196980,0.262412925,TX,Dallas County,,705941,403170,294339,0.57111005,0.416945609,108831,0.154164442
48115,835,2636,3562,0.234418866,0.740033689,1801,-0.505614823,TX,Dawson County,,3640,1017,2591,0.279395604,0.711813187,1574,-0.432417582
48117,1185,2911,4201,0.282075696,0.692930255,1726,-0.410854558,TX,Deaf Smith County,,4309,1239,3042,0.287537712,0.705964261,1803,-0.418426549
48119,400,1836,2279,0.175515577,0.805616498,1436,-0.630100921,TX,Delta County,,2018,454,1524,0.224975223,0.755203171,1070,-0.530227948
48121,110000,169175,293287,0.375059242,0.576824067,59175,-0.201764824,TX,Denton County,,240125,79917,156105,0.332814159,0.650098907,76188,-0.317284748
48123,1161,5510,6822,0.170184697,0.807681032,4349,-0.637496335,TX,DeWitt County,,6624,1463,5114,0.220863527,0.772041063,3651,-0.551177536
48125,128,755,909,0.140814081,0.830583058,627,-0.689768977,TX,Dickens County,,1019,216,793,0.211972522,0.778213935,577,-0.566241413
48127,2173,974,3225,0.67379845,0.302015504,1199,0.371782946,TX,Dimmit County,,2917,2141,762,0.73397326,0.261227288,1379,0.472745972
48129,190,1225,1460,0.130136986,0.839041096,1035,-0.70890411,TX,Donley County,,1533,226,1286,0.147423353,0.838878017,1060,-0.691454664
48131,2783,1316,4159,0.669151238,0.316422217,1467,0.352729021,TX,Duval County,,4343,3331,979,0.766981349,0.225420216,2352,0.541561133
48133,776,6008,6935,0.111896179,0.866330209,5232,-0.75443403,TX,Eastland County,,6494,970,5443,0.149368648,0.8381583,4473,-0.688789652
48135,10225,24976,36373,0.281115113,0.686663184,14751,-0.405548071,TX,Ector County,,32408,8095,23936,0.249784004,0.738583066,15841,-0.488799062
48137,302,741,1065,0.283568075,0.695774648,439,-0.412206573,TX,Edwards County,,883,232,641,0.262740657,0.725934315,409,-0.463193658
48139,16197,44807,63064,0.256834327,0.710500444,28610,-0.453666117,TX,Ellis County,,53756,13803,39353,0.256771337,0.732067118,25550,-0.475295781
48141,145509,54567,210458,0.691392107,0.259277386,90942,0.432114721,TX,El Paso County,,171053,112273,56517,0.656363817,0.330406365,55756,0.325957452
48143,2159,11205,13810,0.156335988,0.811368573,9046,-0.655032585,TX,Erath County,,12467,1965,10325,0.157616107,0.828186412,8360,-0.670570306
48145,1682,3438,5232,0.32148318,0.657110092,1756,-0.335626911,TX,Falls County,,5432,2033,3356,0.374263623,0.617820324,1323,-0.243556701
48147,2123,9536,11972,0.177330438,0.796525226,7413,-0.619194788,TX,Fannin County,,10781,2482,8143,0.230219831,0.755310268,5661,-0.525090437
48149,2127,8648,11029,0.1928552,0.784114607,6521,-0.591259407,TX,Fayette County,,10534,2311,8098,0.219384849,0.768748813,5787,-0.549363964
48151,403,1265,1722,0.234030197,0.734610918,862,-0.50058072,TX,Fisher County,,1628,512,1094,0.314496314,0.671990172,582,-0.357493857
48153,435,1473,1958,0.222165475,0.752298264,1038,-0.530132789,TX,Floyd County,,2085,551,1523,0.264268585,0.730455635,972,-0.46618705
48155,113,383,511,0.221135029,0.749510763,270,-0.528375734,TX,Foard County,,493,140,346,0.283975659,0.701825558,206,-0.417849899
48157,134475,117212,260367,0.516482504,0.450179938,17263,0.066302565,TX,Fort Bend County,,219250,101043,116028,0.460857469,0.529204105,14985,-0.068346636
48159,665,3583,4356,0.152662994,0.822543618,2918,-0.669880624,TX,Franklin County,,4255,750,3446,0.17626322,0.80987074,2696,-0.633607521
48161,1461,5995,7608,0.1920347,0.78798633,4534,-0.59595163,TX,Freestone County,,7562,1848,5644,0.244379794,0.746363396,3796,-0.501983602
48163,1401,1232,2683,0.522176668,0.459187477,169,0.062989191,TX,Frio County,,3968,2376,1559,0.598790323,0.392893145,817,0.205897177
48165,597,3907,4609,0.129529182,0.847689304,3310,-0.718160122,TX,Gaines County,,4066,535,3484,0.131578947,0.856861781,2949,-0.725282833
48167,45503,73566,123994,0.366977434,0.593302902,28063,-0.226325467,TX,Galveston County,,109227,39162,68594,0.358537724,0.62799491,29432,-0.269457185
48169,224,1223,1475,0.151864407,0.829152542,999,-0.677288136,TX,Garza County,,1556,276,1262,0.177377892,0.811053985,986,-0.633676093
48171,2286,10445,13123,0.174197973,0.795930809,8159,-0.621732835,TX,Gillespie County,,12535,2055,10305,0.163940965,0.822098125,8250,-0.65815716
48173,34,553,602,0.056478405,0.918604651,519,-0.862126246,TX,Glasscock County,,578,44,526,0.076124567,0.910034602,482,-0.833910035
48175,973,2618,3713,0.262052249,0.705090224,1645,-0.443037975,TX,Goliad County,,3452,1127,2294,0.326477404,0.664542294,1167,-0.33806489
48177,1567,4580,6304,0.248572335,0.726522843,3013,-0.477950508,TX,Gonzales County,,6039,1773,4213,0.293591654,0.697632058,2440,-0.404040404
48179,699,6495,7360,0.094972826,0.882472826,5796,-0.7875,TX,Gray County,,7373,885,6428,0.120032551,0.871829649,5543,-0.751797098
48181,10276,35274,47068,0.218322427,0.749426362,24998,-0.531103935,TX,Grayson County,,42207,10665,30907,0.252683204,0.732271898,20242,-0.479588694
48183,11623,28693,41365,0.280986341,0.693654055,17070,-0.412667714,TX,Gregg County,,41356,12336,28665,0.298288036,0.693127962,16329,-0.394839926
48185,2194,7065,9528,0.230268682,0.741498741,4871,-0.511230059,TX,Grimes County,,8598,2339,6141,0.272040009,0.714235869,3802,-0.44219586
48187,18308,36495,57220,0.319958057,0.637801468,18187,-0.317843411,TX,Guadalupe County,,49247,15654,32959,0.317867078,0.669259041,17305,-0.351391963
48189,2090,6347,8802,0.237446035,0.721086117,4257,-0.483640082,TX,Hale County,,8765,2228,6417,0.254192812,0.732116372,4189,-0.47792356
48191,164,891,1089,0.150596878,0.818181818,727,-0.66758494,TX,Hall County,,1108,265,832,0.239169675,0.750902527,567,-0.511732852
48193,479,3056,3609,0.132723746,0.846771959,2577,-0.714048213,TX,Hamilton County,,3551,591,2918,0.166431991,0.821740355,2327,-0.655308364
48195,171,1730,1947,0.087827427,0.888546482,1559,-0.800719055,TX,Hansford County,,1960,158,1787,0.080612245,0.911734694,1629,-0.831122449
48197,249,1207,1511,0.164791529,0.798808736,958,-0.634017207,TX,Hardeman County,,1495,302,1176,0.202006689,0.786622074,874,-0.584615385
48199,2779,19600,22768,0.122057273,0.860857344,16821,-0.73880007,TX,Hardin County,,21293,3358,17744,0.15770441,0.833325506,14386,-0.675621096
48201,706471,544960,1302887,0.542235052,0.418271116,161511,0.123963935,TX,Harris County,,1185478,585451,584866,0.493852269,0.493358797,585,0.000493472
48203,7130,18712,26364,0.270444546,0.709755728,11582,-0.439311182,TX,Harrison County,,26099,8431,17471,0.323039197,0.669412621,9040,-0.346373424
48205,172,1727,1945,0.088431877,0.887917738,1555,-0.799485861,TX,Hartley County,,1904,183,1700,0.096113445,0.892857143,1517,-0.796743697
48207,314,1403,1765,0.177903683,0.79490085,1089,-0.616997167,TX,Haskell County,,2006,551,1422,0.274675972,0.70887338,871,-0.434197408
48209,33117,33730,71524,0.463019406,0.471589956,613,-0.00857055,TX,Hays County,,58808,25448,31577,0.432730241,0.536950755,6129,-0.104220514
48211,181,1460,1687,0.107291049,0.865441612,1279,-0.758150563,TX,Hemphill County,,1509,192,1298,0.127236581,0.8601723,1106,-0.732935719
48213,5649,23574,29855,0.189214537,0.78961648,17925,-0.600401943,TX,Henderson County,,27582,6094,21202,0.220941194,0.768689725,15108,-0.547748532
48215,118739,48608,172990,0.686392277,0.28098734,70131,0.405404937,TX,Hidalgo County,,138966,97879,39786,0.704337752,0.286300246,58093,0.418037506
48217,2535,10075,12906,0.19642027,0.780644661,7540,-0.584224392,TX,Hill County,,12032,2745,9128,0.228141622,0.758643617,6383,-0.530501995
48219,1257,5793,7282,0.172617413,0.795523208,4536,-0.622905795,TX,Hockley County,,7119,1482,5543,0.208175306,0.778620593,4061,-0.570445287
48221,4001,21367,26120,0.153177642,0.818032159,17366,-0.664854518,TX,Hood County,,22445,3829,18341,0.170594787,0.817153041,14512,-0.646558254
48223,2508,10704,13476,0.186108638,0.79430098,8196,-0.608192342,TX,Hopkins County,,12742,2775,9834,0.217783707,0.771778371,7059,-0.553994663
48225,1978,6205,8302,0.238255842,0.747410263,4227,-0.509154421,TX,Houston County,,8129,2235,5839,0.274941567,0.718292533,3604,-0.443350966
48227,1768,6635,8692,0.20340543,0.763345605,4867,-0.559940175,TX,Howard County,,5139,1042,4032,0.202763183,0.784588441,2990,-0.581825258
48229,324,503,871,0.371986223,0.57749713,179,-0.205510907,TX,Hudspeth County,,861,379,471,0.44018583,0.547038328,92,-0.106852497
48231,6301,23866,31185,0.202052269,0.765303832,17565,-0.563251563,TX,Hunt County,,27984,6658,20976,0.23792167,0.749571184,14318,-0.511649514
48233,854,7039,8126,0.105094758,0.866231848,6185,-0.761137091,TX,Hutchinson County,,7916,1042,6797,0.131632137,0.858640728,5755,-0.72700859
48235,90,660,760,0.118421053,0.868421053,570,-0.75,TX,Irion County,,788,112,668,0.14213198,0.847715736,556,-0.705583756
48237,314,2973,3339,0.094040132,0.890386343,2659,-0.796346211,TX,Jack County,,2907,303,2580,0.104231166,0.8875129,2277,-0.783281734
48239,904,4266,5275,0.171374408,0.808720379,3362,-0.637345972,TX,Jackson County,,5018,1068,3903,0.212833798,0.77779992,2835,-0.564966122
48241,2582,10578,13351,0.193393753,0.792300202,7996,-0.598906449,TX,Jasper County,,13466,3402,9924,0.252636269,0.736967177,6522,-0.484330907
48243,422,694,1175,0.359148936,0.590638298,272,-0.231489362,TX,Jeff Davis County,,1188,440,717,0.37037037,0.603535354,277,-0.233164983
48245,42404,42828,87363,0.485377105,0.490230418,424,-0.004853313,TX,Jefferson County,,88548,44626,43214,0.503975245,0.488029092,1412,0.015946153
48247,1635,430,2119,0.771590373,0.202925908,1205,0.568664464,TX,Jim Hogg County,,1667,1301,356,0.780443911,0.213557289,945,0.566886623
48249,6688,5411,12346,0.541713915,0.438279605,1277,0.103434311,TX,Jim Wells County,,11163,6492,4595,0.581564096,0.411627699,1897,0.169936397
48251,10976,44370,57270,0.191653571,0.774751179,33394,-0.583097608,TX,Johnson County,,48753,10481,37609,0.214981642,0.771419195,27128,-0.556437553
48253,935,4815,5932,0.15761969,0.811699258,3880,-0.654079568,TX,Jones County,,5562,1225,4258,0.220244516,0.76555196,3033,-0.545307443
48255,1144,2959,4185,0.273357228,0.707048984,1815,-0.433691756,TX,Karnes County,,4180,1324,2823,0.316746411,0.675358852,1499,-0.35861244
48257,10265,29537,40979,0.250494156,0.720783816,19272,-0.470289661,TX,Kaufman County,,34604,9451,24804,0.273118715,0.716795746,15353,-0.443677032
48259,3633,15663,19936,0.182233146,0.785664125,12030,-0.603430979,TX,Kendall County,,17729,3035,14467,0.171188448,0.816007671,11432,-0.644819223
48261,99,84,186,0.532258065,0.451612903,15,0.080645161,TX,Kenedy County,,166,82,83,0.493975904,0.5,1,-0.006024096
48263,59,360,433,0.136258661,0.831408776,301,-0.695150115,TX,Kent County,,404,66,334,0.163366337,0.826732673,268,-0.663366337
48265,4665,17658,23090,0.202035513,0.764746644,12993,-0.56271113,TX,Kerr County,,21811,4325,17225,0.198294439,0.789739122,12900,-0.591444684
48267,206,1697,1945,0.105912596,0.872493573,1491,-0.766580977,TX,Kimble County,,1891,217,1667,0.114754098,0.881544157,1450,-0.766790058
48269,5,149,159,0.031446541,0.937106918,144,-0.905660377,TX,King County,,145,5,139,0.034482759,0.95862069,134,-0.924137931
48271,457,936,1424,0.320926966,0.657303371,479,-0.336376404,TX,Kinney County,,1425,522,880,0.366315789,0.61754386,358,-0.25122807
48273,4713,4364,9483,0.496994622,0.460191922,349,0.0368027,TX,Kleberg County,,8902,4752,4056,0.533812626,0.455627949,696,0.078184678
48275,247,1078,1358,0.181885125,0.793814433,831,-0.611929308,TX,Knox County,,1510,332,1160,0.21986755,0.768211921,828,-0.548344371
48277,3579,14546,18537,0.193073313,0.784700869,10967,-0.591627556,TX,Lamar County,,17173,4173,12814,0.242997729,0.746171315,8641,-0.503173586
48279,770,3040,3905,0.197183099,0.778489117,2270,-0.581306018,TX,Lamb County,,4089,998,3056,0.244069455,0.747370995,2058,-0.503301541
48281,1479,6371,8149,0.181494662,0.781813719,4892,-0.600319058,TX,Lampasas County,,7138,1457,5583,0.204118801,0.782151863,4126,-0.578033062
48283,1125,870,2049,0.549048316,0.424597365,255,0.124450952,TX,La Salle County,,1646,965,669,0.586269745,0.406439854,296,0.179829891
48285,1170,7339,8633,0.135526468,0.850110043,6169,-0.714583575,TX,Lavaca County,,8279,1427,6788,0.172363812,0.819905786,5361,-0.647541974
48287,1372,4996,6522,0.210364919,0.766022692,3624,-0.555657774,TX,Lee County,,6211,1630,4504,0.262437611,0.72516503,2874,-0.462727419
48289,909,6391,7407,0.12272175,0.862832456,5482,-0.740110706,TX,Leon County,,6941,1061,5812,0.152859818,0.837343322,4751,-0.684483504
48291,4851,18856,24155,0.200827986,0.780625129,14005,-0.579797143,TX,Liberty County,,22711,5196,17304,0.228787812,0.761921536,12108,-0.533133724
48293,1748,5747,7648,0.228556485,0.751438285,3999,-0.522881799,TX,Limestone County,,7563,2208,5288,0.29194764,0.699193442,3080,-0.407245802
48295,135,1159,1322,0.102118003,0.876701967,1024,-0.774583964,TX,Lipscomb County,,1168,119,1044,0.101883562,0.893835616,925,-0.791952055
48297,739,3450,4267,0.173189595,0.808530584,2711,-0.635340989,TX,Live Oak County,,4108,915,3153,0.222736125,0.767526777,2238,-0.544790652
48299,1825,8283,10377,0.175869712,0.798207574,6458,-0.622337863,TX,Llano County,,9502,1818,7560,0.191328141,0.795621974,5742,-0.604293833
48301,4,57,64,0.0625,0.890625,53,-0.828125,TX,Loving County,,64,9,54,0.140625,0.84375,45,-0.703125
48303,27956,65566,98060,0.285090761,0.66863145,37610,-0.383540689,TX,Lubbock County,,90615,26088,63133,0.287899354,0.696716879,37045,-0.408817525
48305,403,1546,1997,0.201802704,0.774161242,1143,-0.572358538,TX,Lynn County,,1852,464,1377,0.250539957,0.743520518,913,-0.492980562
48307,480,2546,3086,0.155541154,0.825016202,2066,-0.669475049,TX,McCulloch County,,2993,537,2419,0.179418644,0.808219178,1882,-0.628800535
48309,27046,48245,78255,0.345613699,0.616510127,21199,-0.270896428,TX,McLennan County,,74493,25688,47885,0.34483777,0.642812076,22197,-0.297974306
48311,40,454,497,0.080482897,0.913480885,414,-0.832997988,TX,McMullen County,,508,67,436,0.131889764,0.858267717,369,-0.726377953
48313,881,3349,4283,0.205696941,0.781928555,2468,-0.576231613,TX,Madison County,,4025,964,3028,0.239503106,0.752298137,2064,-0.512795031
48315,1156,2968,4206,0.274845459,0.705658583,1812,-0.430813124,TX,Marion County,,4271,1487,2730,0.348162023,0.639194568,1243,-0.291032545
48317,266,1453,1755,0.151566952,0.827920228,1187,-0.676353276,TX,Martin County,,1593,247,1338,0.155053358,0.83992467,1091,-0.684871312
48319,353,1656,2053,0.171943497,0.806624452,1303,-0.634680955,TX,Mason County,,1965,380,1562,0.193384224,0.794910941,1182,-0.601526718
48321,3357,8147,11779,0.284998727,0.69165464,4790,-0.406655913,TX,Matagorda County,,12110,3972,8026,0.327993394,0.662758051,4054,-0.334764657
48323,10397,2816,13588,0.765160436,0.207241684,7581,0.557918752,TX,Maverick County,,10562,8302,2171,0.786025374,0.205548192,6131,0.580477182
48325,4624,12054,17187,0.269040554,0.701344039,7430,-0.432303485,TX,Medina County,,15948,4760,11016,0.298470028,0.690744921,6256,-0.392274893
48327,153,681,860,0.177906977,0.791860465,528,-0.613953488,TX,Menard County,,846,170,663,0.200945626,0.783687943,493,-0.582742317
48329,9993,36896,48753,0.204972002,0.756794454,26903,-0.551822452,TX,Midland County,,44277,8223,35452,0.18571719,0.800686587,27229,-0.614969397
48331,2042,6340,8607,0.237248751,0.736609736,4298,-0.499360985,TX,Milam County,,8220,2632,5478,0.320194647,0.666423358,2846,-0.34622871
48333,242,1949,2238,0.108132261,0.870866845,1707,-0.762734584,TX,Mills County,,2197,279,1882,0.126991352,0.856622667,1603,-0.729631315
48335,353,1780,2190,0.161187215,0.812785388,1427,-0.651598174,TX,Mitchell County,,2312,536,1754,0.23183391,0.758650519,1218,-0.526816609
48337,885,7526,8604,0.102859135,0.874709437,6641,-0.771850302,TX,Montague County,,7737,1116,6539,0.144241954,0.845159623,5423,-0.700917668
48339,45744,150188,203083,0.225247805,0.739539991,104444,-0.514292186,TX,Montgomery County,,172820,32852,137822,0.190093739,0.797488717,104970,-0.607394977
48341,1096,3974,5262,0.208285823,0.75522615,2878,-0.546940327,TX,Moore County,,4983,963,3967,0.193257074,0.796106763,3004,-0.602849689
48343,1425,3443,4964,0.287066882,0.693593876,2018,-0.406526994,TX,Morris County,,5129,1856,3226,0.361863911,0.628972509,1370,-0.267108598
48345,40,571,620,0.064516129,0.920967742,531,-0.856451613,TX,Motley County,,599,55,538,0.091819699,0.898163606,483,-0.806343907
48347,6822,14751,22430,0.304146233,0.65764601,7929,-0.353499777,TX,Nacogdoches County,,20601,6441,13910,0.312654725,0.675209941,7469,-0.362555216
48349,3998,11984,16382,0.244048346,0.731534611,7986,-0.487486265,TX,Navarro County,,15316,4348,10838,0.283886132,0.707626012,6490,-0.42373988
48351,978,2961,4010,0.243890274,0.73840399,1983,-0.494513716,TX,Newton County,,6188,1721,4399,0.27811894,0.710892049,2678,-0.432773109
48353,1029,3551,4744,0.216905565,0.748524452,2522,-0.531618887,TX,Nolan County,,4567,1216,3277,0.266257937,0.717538866,2061,-0.451280928
48355,49102,50704,103958,0.472325362,0.487735432,1602,-0.015410069,TX,Nueces County,,95781,45666,48779,0.476775143,0.50927637,3113,-0.032501227
48357,274,2628,2981,0.091915465,0.881583361,2354,-0.789667897,TX,Ochiltree County,,2990,253,2718,0.084615385,0.9090301,2465,-0.824414716
48359,78,850,945,0.082539683,0.899470899,772,-0.816931217,TX,Oldham County,,865,71,786,0.082080925,0.90867052,715,-0.826589595
48361,5716,25385,31761,0.179969145,0.799250653,19669,-0.619281509,TX,Orange County,,30502,6797,23361,0.222837847,0.765884204,16564,-0.543046358
48363,1700,8222,10175,0.167076167,0.808058968,6522,-0.640982801,TX,Palo Pinto County,,9335,1810,7392,0.193893948,0.791858597,5582,-0.597964649
48365,1835,8445,10413,0.17622203,0.811005474,6610,-0.634783444,TX,Panola County,,10221,2211,7941,0.216319343,0.77692985,5730,-0.560610508
48367,8329,46433,56413,0.147643274,0.823090422,38104,-0.675447149,TX,Parker County,,47346,7804,38980,0.16482913,0.823300807,31176,-0.658471677
48369,848,1911,2818,0.30092264,0.678140525,1063,-0.377217885,TX,Parmer County,,2545,528,2005,0.207465619,0.787819253,1477,-0.580353635
48371,1551,2463,4167,0.372210223,0.591072714,912,-0.218862491,TX,Pecos County,,4147,1591,2512,0.383650832,0.605739088,921,-0.222088257
48373,7123,26587,34444,0.206799443,0.771890605,19464,-0.565091162,TX,Polk County,,19058,4836,14019,0.253751705,0.7355966,9183,-0.481844895
48375,7620,19499,28330,0.26897282,0.688280974,11879,-0.419308154,TX,Potter County,,26418,7114,18905,0.269286093,0.715610569,11791,-0.446324476
48377,1458,652,2203,0.661824784,0.295960054,806,0.36586473,TX,Presidio County,,1808,1273,504,0.70409292,0.278761062,769,0.425331858
48379,619,3919,4630,0.133693305,0.846436285,3300,-0.712742981,TX,Rains County,,4065,754,3265,0.185485855,0.803198032,2511,-0.617712177
48381,8340,43379,53813,0.154981138,0.806106331,35039,-0.651125193,TX,Randall County,,49588,7553,41366,0.152315076,0.834193757,33813,-0.68187868
48383,167,709,900,0.185555556,0.787777778,542,-0.602222222,TX,Reagan County,,843,158,676,0.18742586,0.801897983,518,-0.614472123
48385,262,1382,1678,0.15613826,0.823599523,1120,-0.667461263,TX,Real County,,1533,277,1236,0.180691455,0.806262231,959,-0.625570776
48387,1148,3924,5147,0.223042549,0.762385856,2776,-0.539343307,TX,Red River County,,5074,1482,3549,0.292077257,0.699448167,2067,-0.407370911
48389,1659,1417,3184,0.521042714,0.445037688,242,0.076005025,TX,Reeves County,,2867,1649,1185,0.575165678,0.413324032,464,0.161841646
48391,1034,1830,2945,0.351103565,0.62139219,796,-0.270288625,TX,Refugio County,,2673,998,1659,0.373363262,0.620650954,661,-0.247287692
48393,20,524,550,0.036363636,0.952727273,504,-0.916363636,TX,Roberts County,,439,25,408,0.056947608,0.929384966,383,-0.872437358
48395,2203,4665,7010,0.314265335,0.665477889,2462,-0.351212553,TX,Robertson County,,7278,2792,4416,0.383621874,0.606760099,1624,-0.223138225
48397,9633,28396,39529,0.243694503,0.718358673,18763,-0.474664171,TX,Rockwall County,,35651,8112,27098,0.227539199,0.760090881,18986,-0.532551682
48399,452,3241,3765,0.120053121,0.860823373,2789,-0.740770252,TX,Runnels County,,3665,517,3103,0.14106412,0.846657572,2586,-0.705593452
48401,3935,14675,18994,0.207170685,0.772612404,10740,-0.565441718,TX,Rusk County,,18537,4451,13924,0.240114366,0.751146356,9473,-0.51103199
48403,614,3992,4642,0.132270573,0.859974149,3378,-0.727703576,TX,Sabine County,,4572,806,3726,0.176290464,0.81496063,2920,-0.638670166
48405,907,2620,3563,0.254560763,0.735335392,1713,-0.480774628,TX,San Augustine County,,3690,1193,2469,0.323306233,0.669105691,1276,-0.345799458
48407,2034,8050,10305,0.197379913,0.781174187,6016,-0.583794275,TX,San Jacinto County,,9610,2410,7105,0.250780437,0.739334027,4695,-0.48855359
48409,7825,13004,21513,0.363733556,0.604471715,5179,-0.240738158,TX,San Patricio County,,20064,7854,11994,0.391447368,0.597787081,4140,-0.206339713
48411,293,2025,2354,0.124468989,0.860237893,1732,-0.735768904,TX,San Saba County,,2256,323,1905,0.143173759,0.844414894,1582,-0.701241135
48413,209,819,1054,0.19829222,0.777039848,610,-0.578747628,TX,Schleicher County,,1010,220,781,0.217821782,0.773267327,561,-0.555445545
48415,733,4403,5261,0.139327124,0.836913134,3670,-0.69758601,TX,Scurry County,,5022,837,4121,0.166666667,0.820589407,3284,-0.65392274
48417,103,1378,1502,0.068575233,0.917443409,1275,-0.848868176,TX,Shackelford County,,1363,131,1218,0.096111519,0.893617021,1087,-0.797505503
48419,1757,7171,9072,0.19367284,0.790454145,5414,-0.596781305,TX,Shelby County,,9261,2318,6870,0.250296944,0.741820538,4552,-0.491523594
48421,96,807,933,0.102893891,0.864951768,711,-0.762057878,TX,Sherman County,,1038,121,908,0.116570328,0.874759152,787,-0.758188825
48423,22128,58631,83161,0.266086266,0.705030002,36503,-0.438943736,TX,Smith County,,84794,22101,61858,0.260643442,0.729509163,39757,-0.468865722
48425,540,3206,3876,0.139318885,0.827141383,2666,-0.687822497,TX,Somervell County,,3507,609,2858,0.173652695,0.814941545,2249,-0.641288851
48427,9246,2218,11691,0.790864768,0.189718587,7028,0.601146181,TX,Starr County,,11859,10248,1540,0.864153807,0.129859179,8708,0.734294629
48429,348,3033,3453,0.100781929,0.878366638,2685,-0.777584709,TX,Stephens County,,3407,475,2891,0.139418844,0.848547109,2416,-0.709128265
48431,70,549,633,0.110584518,0.867298578,479,-0.75671406,TX,Sterling County,,494,31,459,0.062753036,0.929149798,428,-0.866396761
48433,135,555,701,0.192582026,0.791726106,420,-0.59914408,TX,Stonewall County,,675,160,507,0.237037037,0.751111111,347,-0.514074074
48435,313,1075,1415,0.221201413,0.759717314,762,-0.538515901,TX,Sutton County,,1489,369,1110,0.247817327,0.745466756,741,-0.497649429
48437,462,1671,2190,0.210958904,0.763013699,1209,-0.552054795,TX,Swisher County,,2265,579,1654,0.255629139,0.730242826,1075,-0.474613687
48439,288001,345683,662832,0.434500748,0.521524308,57682,-0.08702356,TX,Tarrant County,,610149,252789,348686,0.414306997,0.571476803,95897,-0.157169806
48441,10047,33172,45266,0.221954668,0.732823753,23125,-0.510869085,TX,Taylor County,,43170,9725,32853,0.22527218,0.761014593,23128,-0.535742414
48443,140,287,437,0.320366133,0.656750572,147,-0.336384439,TX,Terrell County,,553,184,358,0.332730561,0.647377939,174,-0.314647378
48445,424,1295,1763,0.240499149,0.734543392,871,-0.494044243,TX,Terry County,,3707,1059,2602,0.285675749,0.701915295,1543,-0.416239547
48447,84,715,808,0.103960396,0.88490099,631,-0.780940594,TX,Throckmorton County,,813,109,700,0.134071341,0.86100861,591,-0.726937269
48449,2538,6405,9176,0.276591107,0.698016565,3867,-0.421425458,TX,Titus County,,8790,2638,6062,0.300113766,0.689647327,3424,-0.389533561
48451,9117,27376,38104,0.239266219,0.718454755,18259,-0.479188537,TX,Tom Green County,,36527,9246,26749,0.253127823,0.732307608,17503,-0.479179785
48453,306475,126750,462511,0.662632889,0.274047536,179725,0.388585353,TX,Travis County,,384890,231540,139503,0.601574476,0.362449011,92037,0.239125464
48455,1154,4737,5982,0.19291207,0.791875627,3583,-0.598963557,TX,Trinity County,,6234,1614,4537,0.258902791,0.727783125,2923,-0.468880334
48457,1243,6601,7969,0.15597942,0.828334797,5358,-0.672355377,TX,Tyler County,,7623,1659,5889,0.217630854,0.7725305,4230,-0.554899646
48459,2378,13198,15918,0.149390627,0.829124262,10820,-0.679733635,TX,Upshur County,,15049,2953,11948,0.196225663,0.793939797,8995,-0.597714134
48461,284,961,1296,0.219135802,0.741512346,677,-0.522376543,TX,Upton County,,1298,332,952,0.25577812,0.733436055,620,-0.477657935
48463,3863,4828,8936,0.432296329,0.540286482,965,-0.107990152,TX,Uvalde County,,8431,3824,4526,0.453564227,0.536828371,702,-0.083264144
48465,6920,5856,13476,0.513505491,0.434550312,1064,0.07895518,TX,Val Verde County,,12040,6267,5612,0.52051495,0.466112957,655,0.054401993
48467,2792,18436,21689,0.128728849,0.850016137,15644,-0.721287288,TX,Van Zandt County,,19081,3083,15790,0.161574341,0.827524763,12707,-0.665950422
48469,8843,21253,31032,0.284963908,0.684873679,12410,-0.399909771,TX,Victoria County,,28827,8795,19684,0.305095917,0.682832067,10889,-0.37773615
48471,6085,12878,19683,0.309150028,0.654270182,6793,-0.345120154,TX,Walker County,,15066,5283,9569,0.350657109,0.635138723,4286,-0.284481614
48473,5744,10525,16715,0.343643434,0.629673946,4781,-0.286030512,TX,Waller County,,15699,6401,9158,0.407732977,0.583349258,2757,-0.175616281
48475,780,2541,3413,0.228537943,0.744506299,1761,-0.515968356,TX,Ward County,,3238,836,2364,0.258184064,0.730080296,1528,-0.471896232
48477,3381,10944,14747,0.22926697,0.742117041,7563,-0.512850071,TX,Washington County,,14373,3378,10850,0.235024003,0.754887637,7472,-0.519863633
48479,42297,12946,56867,0.743788137,0.227654,29351,0.516134138,TX,Webb County,,49101,37592,11074,0.765605588,0.225535121,26518,0.540070467
48481,4238,10149,14707,0.2881621,0.690079554,5911,-0.401917454,TX,Wharton County,,14087,4235,9750,0.300631788,0.692127493,5515,-0.391495705
48483,194,2087,2306,0.084128361,0.905030356,1893,-0.820901995,TX,Wheeler County,,2128,232,1878,0.109022556,0.882518797,1646,-0.773496241
48485,8752,27609,37913,0.230844301,0.728219872,18857,-0.49737557,TX,Wichita County,,40923,10490,29756,0.256335068,0.727121668,19266,-0.470786599
48487,807,3166,4101,0.196781273,0.772006828,2359,-0.575225555,TX,Wilbarger County,,3980,971,2956,0.243969849,0.742713568,1985,-0.498743719
48489,3416,1541,5082,0.672176309,0.303227076,1875,0.368949233,TX,Willacy County,,5058,3595,1415,0.710755239,0.279754844,2180,0.431000395
48491,84252,104029,200524,0.420159183,0.518785781,19777,-0.098626598,TX,Williamson County,,162936,61812,96910,0.379363677,0.594773408,35098,-0.215409731
48493,4790,13991,19255,0.248766554,0.726616463,9201,-0.477849909,TX,Wilson County,,17186,4819,12205,0.280402653,0.710171069,7386,-0.429768416
48495,420,1403,1873,0.224239188,0.74906567,983,-0.524826482,TX,Winkler County,,1745,398,1331,0.228080229,0.762750716,933,-0.534670487
48497,3412,20655,24661,0.138356109,0.837557277,17243,-0.699201168,TX,Wise County,,20692,3219,17178,0.155567369,0.830175913,13959,-0.674608544
48499,2624,15681,18646,0.140727234,0.840984662,13057,-0.700257428,TX,Wood County,,17541,3052,14317,0.173992361,0.816202041,11265,-0.64220968
48501,426,1797,2299,0.185297956,0.781644193,1371,-0.596346237,TX,Yoakum County,,2128,409,1698,0.192199248,0.797932331,1289,-0.605733083
48503,873,6587,7658,0.113998433,0.860146252,5714,-0.746147819,TX,Young County,,7316,992,6225,0.13559322,0.850874795,5233,-0.715281575
48505,2056,1028,3134,0.656030632,0.328015316,1028,0.328015316,TX,Zapata County,,3529,2517,993,0.713233211,0.281382828,1524,0.431850383
48507,2633,692,3390,0.776696165,0.204129794,1941,0.572566372,TX,Zavala County,,3653,3042,574,0.832740214,0.157131125,2468,0.675609088
49001,264,1838,2490,0.106024096,0.73815261,1574,-0.632128514,UT,Beaver County,,2534,341,2153,0.13456985,0.84964483,1812,-0.71507498
49003,1814,10324,16548,0.109620498,0.62388204,8510,-0.514261542,UT,Box Elder County,,18092,1830,15969,0.101149679,0.882655317,14139,-0.781505638
49005,6705,16643,35879,0.186878118,0.463864656,9938,-0.276986538,UT,Cache County,,37099,5434,30818,0.146472951,0.830696245,25384,-0.684223294
49007,1696,5182,7818,0.216935278,0.662829368,3486,-0.445894091,UT,Carbon County,,7231,2204,4834,0.304798783,0.668510579,2630,-0.363711796
49009,76,327,465,0.16344086,0.703225806,251,-0.539784946,UT,Daggett County,,509,91,399,0.178781925,0.78388998,308,-0.605108055
49011,22575,46985,104661,0.215696391,0.448925579,24410,-0.233229188,UT,Davis County,,112568,20417,90030,0.181374813,0.799783242,69613,-0.618408429
49013,500,5505,6932,0.072129256,0.794143104,5005,-0.722013849,UT,Duchesne County,,6273,570,5608,0.090865615,0.893990116,5038,-0.803124502
49015,379,3402,4263,0.088904527,0.798029557,3023,-0.709125029,UT,Emery County,,4414,569,3743,0.12890802,0.847983688,3174,-0.719075668
49017,352,1577,2294,0.153443766,0.68744551,1225,-0.534001744,UT,Garfield County,,2157,306,1811,0.1418637,0.839592026,1505,-0.697728326
49019,1932,1934,4456,0.433572711,0.434021544,2,-0.000448833,UT,Grand County,,3812,1678,1917,0.440188877,0.502885624,239,-0.062696747
49021,2104,10025,15354,0.137032695,0.652924319,7921,-0.515891624,UT,Iron County,,13168,1720,11172,0.130619684,0.848420413,9452,-0.717800729
49023,436,2759,4076,0.106967615,0.676889107,2323,-0.569921492,UT,Juab County,,3907,436,3400,0.111594574,0.870232915,2964,-0.758638341
49025,739,2248,3482,0.212234348,0.645605974,1509,-0.433371626,UT,Kane County,,3281,718,2463,0.218835721,0.750685767,1745,-0.531850046
49027,431,3860,5234,0.082346198,0.737485671,3429,-0.655139473,UT,Millard County,,4958,424,4421,0.085518354,0.891690198,3997,-0.806171843
49029,572,3156,5136,0.111370717,0.614485981,2584,-0.503115265,UT,Morgan County,,4370,386,3910,0.088329519,0.894736842,3524,-0.806407323
49031,31,537,617,0.050243112,0.870340357,506,-0.820097245,UT,Piute County,,781,74,696,0.09475032,0.891165173,622,-0.796414853
49033,104,786,1096,0.094890511,0.717153285,682,-0.622262774,UT,Rich County,,999,83,907,0.083083083,0.907907908,824,-0.824824825
49035,154831,117901,361347,0.428482871,0.32628194,36930,0.102200932,UT,Salt Lake County,,341664,132686,198739,0.388352299,0.581679662,66053,-0.193327363
49037,1997,2635,5385,0.37084494,0.489322191,638,-0.118477252,UT,San Juan County,,5159,2062,3006,0.399689862,0.58267106,944,-0.182981198
49039,1026,6436,9778,0.104929433,0.658212313,5410,-0.55328288,UT,Sanpete County,,8804,889,7767,0.100976829,0.882212631,6878,-0.781235802
49041,673,6455,8308,0.081006259,0.776961964,5782,-0.695955705,UT,Sevier County,,7781,701,6961,0.090091248,0.894615088,6260,-0.80452384
49043,10251,7160,20133,0.509164059,0.355635027,3091,0.153529032,UT,Summit County,,16616,7656,8464,0.460760713,0.509388541,808,-0.048627829
49045,4015,9693,18905,0.212377678,0.512721502,5678,-0.300343824,UT,Tooele County,,16422,3794,12240,0.231031543,0.745341615,8446,-0.514310072
49047,1002,9876,12883,0.077776915,0.766591632,8874,-0.688814717,UT,Uintah County,,11116,962,10001,0.086541922,0.899694135,9039,-0.813152213
49049,24579,89755,174942,0.140497994,0.513055756,65176,-0.372557762,UT,Utah County,,161278,15791,142337,0.09791168,0.882556827,126546,-0.784645147
49051,3063,6115,12120,0.252722772,0.504537954,3052,-0.251815182,UT,Wasatch County,,9109,2097,6852,0.230211878,0.752223076,4755,-0.522011198
49053,9583,39566,57494,0.166678262,0.688176158,29983,-0.521497895,UT,Washington County,,49733,7762,41104,0.156073432,0.826493475,33342,-0.670420043
49055,271,959,1410,0.192198582,0.680141844,688,-0.487943262,UT,Wayne County,,1323,213,1087,0.160997732,0.821617536,874,-0.660619803
49057,22187,38447,81451,0.272396901,0.472026126,16260,-0.199629225,UT,Weber County,,68143,17569,48938,0.257825455,0.718166209,31369,-0.460340754
50001,11217,5297,17592,0.637619372,0.301102774,5920,0.336516598,VT,Addison County,,17843,12290,5214,0.688785518,0.292215435,7076,0.396570084
50003,9539,5925,16345,0.583603548,0.362496176,3614,0.221107372,VT,Bennington County,,17512,11517,5687,0.657663317,0.324748744,5830,0.332914573
50005,6445,5533,12966,0.497069258,0.426731451,912,0.070337807,VT,Caledonia County,,13545,8192,5088,0.604798819,0.375636766,3104,0.229162052
50007,54463,18298,77263,0.704904029,0.236827459,36165,0.46807657,VT,Chittenden County,,76531,53615,21567,0.700565784,0.281807372,32048,0.418758412
50009,1019,1506,2706,0.376570584,0.55654102,487,-0.179970436,VT,Essex County,,2769,1539,1169,0.555796316,0.42217407,370,0.133622246
50011,9351,8752,19373,0.482682083,0.451762763,599,0.030919321,VT,Franklin County,,19755,12057,7405,0.6103265,0.374841812,4652,0.235484687
50013,2094,1487,3778,0.554261514,0.393594494,607,0.16066702,VT,Grand Isle County,,4064,2531,1471,0.622785433,0.361958661,1060,0.260826772
50015,7241,3570,11641,0.622025599,0.306674684,3671,0.315350915,VT,Lamoille County,,11924,8371,3352,0.70202952,0.28111372,5019,0.4209158
50017,7522,4997,13464,0.558674985,0.371137849,2525,0.187537136,VT,Orange County,,13964,9075,4588,0.64988542,0.328559152,4487,0.321326268
50019,5181,5158,10988,0.471514379,0.469421187,23,0.002093193,VT,Orleans County,,11631,7116,4306,0.611813258,0.370217522,2810,0.241595736
50021,13629,12471,27660,0.492733189,0.450867679,1158,0.04186551,VT,Rutland County,,28414,17087,10834,0.601358485,0.381290913,6253,0.220067572
50023,18594,7993,28654,0.648914637,0.278948838,10601,0.369965799,VT,Washington County,,29049,20349,8092,0.700506042,0.278563806,12257,0.421942236
50025,14340,5462,21151,0.677982129,0.258238381,8878,0.419743747,VT,Windham County,,21805,16080,5344,0.73744554,0.245081403,10736,0.492364137
50027,17544,8604,27832,0.63035355,0.309140558,8940,0.321212992,VT,Windsor County,,28468,19440,8583,0.682871997,0.301496417,10857,0.38137558
51001,6737,8582,15755,0.427610282,0.544715963,1845,-0.117105681,VA,Accomack County,,16020,7653,8212,0.477715356,0.512609238,559,-0.034893883
51003,33297,19232,56134,0.593169915,0.342608758,14065,0.250561157,VA,Albemarle County,,53732,29712,23263,0.552966575,0.432944986,6449,0.120021589
51005,2165,4873,7306,0.296331782,0.666986039,2708,-0.370654257,VA,Alleghany County,,7162,3403,3595,0.475146607,0.501954761,192,-0.026808154
51007,2150,4704,7035,0.305614783,0.668656716,2554,-0.363041933,VA,Amelia County,,6885,2488,4324,0.361365287,0.628031954,1836,-0.266666667
51009,4986,9643,15164,0.328805065,0.635914007,4657,-0.307108942,VA,Amherst County,,14937,5898,8865,0.394858405,0.593492669,2967,-0.198634264
51011,2023,5714,7954,0.25433744,0.718380689,3691,-0.464043249,VA,Appomattox County,,7924,2453,5340,0.309565876,0.67390207,2887,-0.364336194
51013,91879,20155,119344,0.769866939,0.168881552,71724,0.600985387,VA,Arlington County,,117279,81178,34433,0.69217848,0.293599025,46745,0.398579456
51015,8108,26152,36661,0.221161452,0.713346608,18044,-0.492185156,VA,Augusta County,,33614,9448,23614,0.281073362,0.702504909,14166,-0.421431546
51017,603,1548,2243,0.26883638,0.690147124,945,-0.421310745,VA,Bath County,,2218,894,1274,0.403065825,0.574391344,380,-0.171325518
51019,9733,30578,42186,0.230716351,0.724837624,20845,-0.494121272,VA,Bedford County,,40750,10925,29281,0.26809816,0.718552147,18356,-0.450453988
51021,453,2572,3124,0.145006402,0.823303457,2119,-0.678297055,VA,Bland County,,2937,735,2144,0.250255363,0.729996595,1409,-0.479741233
51023,4492,13369,18641,0.240974197,0.717182555,8877,-0.476208358,VA,Botetourt County,,18208,5449,12471,0.29926406,0.684918717,7022,-0.385654657
51025,4473,3045,7645,0.585088293,0.398299542,1428,0.186788751,VA,Brunswick County,,8029,4993,2965,0.621870719,0.369286337,2028,0.252584382
51027,1721,7292,9220,0.186659436,0.790889371,5571,-0.604229935,VA,Buchanan County,,9636,3094,6436,0.321087588,0.667911997,3342,-0.346824408
51029,3128,3969,7284,0.429434377,0.544892916,841,-0.115458539,VA,Buckingham County,,7447,3747,3569,0.503155633,0.479253391,178,0.023902243
51031,6597,19442,27218,0.242376369,0.714306709,12845,-0.47193034,VA,Campbell County,,25632,7591,17687,0.296153246,0.690035893,10096,-0.393882647
51033,6425,7143,14189,0.452815561,0.503418141,718,-0.050602579,VA,Caroline County,,13590,7258,6148,0.534069169,0.452391464,1110,0.081677704
51035,2557,10653,13587,0.188194598,0.784058291,8096,-0.595863693,VA,Carroll County,,12315,3500,8351,0.284206253,0.678116119,4851,-0.393909866
51036,2244,1381,3745,0.599198932,0.368758344,863,0.230440587,VA,Charles City County,,4213,2772,1396,0.657963446,0.331355329,1376,0.326608118
51037,2153,3479,5792,0.371719613,0.600656077,1326,-0.228936464,VA,Charlotte County,,5897,2502,3311,0.424283534,0.561471935,809,-0.137188401
51041,80993,84938,175288,0.462056729,0.484562548,3945,-0.022505819,VA,Chesterfield County,,172223,78954,91174,0.45844051,0.529395029,12220,-0.070954518
51043,3047,4657,8131,0.374738655,0.57274628,1610,-0.198007625,VA,Clarke County,,7731,3237,4295,0.418703919,0.555555556,1058,-0.136851636
51045,541,2139,2784,0.194324713,0.768318966,1598,-0.573994253,VA,Craig County,,2664,830,1757,0.311561562,0.659534535,927,-0.347972973
51047,7744,13341,22087,0.350613483,0.604020465,5597,-0.253406981,VA,Culpeper County,,20131,8263,11549,0.410461477,0.573692315,3286,-0.163230838
51049,2032,2693,4875,0.416820513,0.552410256,661,-0.135589744,VA,Cumberland County,,5040,2422,2538,0.480555556,0.503571429,116,-0.023015873
51051,1335,4932,6405,0.208430913,0.770023419,3597,-0.561592506,VA,Dickenson County,,6878,2472,4274,0.359406804,0.62140157,1802,-0.261994766
51053,5765,7447,13533,0.425995714,0.55028449,1682,-0.124288776,VA,Dinwiddie County,,13339,6425,6769,0.48167029,0.50745933,344,-0.02578904
51057,2541,2657,5354,0.474598431,0.496264475,116,-0.021666044,VA,Essex County,,5666,3009,2602,0.531062478,0.459230498,407,0.07183198
51059,354485,157837,542858,0.652997653,0.290751909,196648,0.362245744,VA,Fairfax County,,440174,260835,173786,0.592572483,0.394812052,87049,0.197760431
51061,12960,22110,37124,0.349100312,0.595571598,9150,-0.246471285,VA,Fauquier County,,35339,13891,20955,0.393078469,0.592970939,7064,-0.19989247
51063,2300,5289,7972,0.288509784,0.663447065,2989,-0.37493728,VA,Floyd County,,7626,2732,4671,0.358248099,0.612509835,1939,-0.254261736
51065,5751,7018,13492,0.426252594,0.520160095,1267,-0.093907501,VA,Fluvanna County,,12724,5885,6678,0.462511789,0.524834958,793,-0.062323169
51067,7254,18560,26805,0.270621153,0.692408133,11306,-0.42178698,VA,Franklin County,,26633,9082,16685,0.341005519,0.626478429,7603,-0.28547291
51069,11920,26069,40133,0.297012434,0.649565196,14149,-0.352552762,VA,Frederick County,,36272,12683,22851,0.349663652,0.629990075,10168,-0.280326423
51071,1949,5930,8196,0.237798926,0.72352367,3981,-0.485724744,VA,Giles County,,7544,2730,4660,0.361876988,0.617709438,1930,-0.25583245
51073,5399,13087,19524,0.276531448,0.670303217,7688,-0.393771768,VA,Gloucester County,,19246,6764,12137,0.351449652,0.630624545,5373,-0.279174893
51075,4884,8374,13930,0.350610194,0.6011486,3490,-0.250538406,VA,Goochland County,,13287,4676,8448,0.351922932,0.635809438,3772,-0.283886506
51077,1407,5593,7258,0.193855056,0.770597961,4186,-0.576742904,VA,Grayson County,,7146,2094,4801,0.293031066,0.671844388,2707,-0.378813322
51079,2923,5943,9503,0.307587078,0.625381458,3020,-0.317794381,VA,Greene County,,8993,3284,5558,0.365172912,0.61803625,2274,-0.252863338
51081,2558,1737,4363,0.586293835,0.398120559,821,0.188173275,VA,Greensville County,,4925,3135,1766,0.636548223,0.35857868,1369,0.277969543
51083,6890,9698,16946,0.406585625,0.572288446,2808,-0.165702821,VA,Halifax County,,16663,7760,8699,0.465702455,0.522054852,939,-0.056352398
51085,19360,39592,62313,0.310689583,0.635373036,20232,-0.324683453,VA,Hanover County,,58936,18283,39920,0.310217863,0.677344917,21637,-0.367127053
51087,93615,59674,161966,0.577991677,0.368435351,33941,0.209556327,VA,Henrico County,,161195,89116,70235,0.552845932,0.435714507,18881,0.117131425
51089,8199,15207,24029,0.341212701,0.632860294,7008,-0.291647592,VA,Henry County,,24927,10312,13980,0.413687969,0.560837646,3668,-0.147149677
51091,371,958,1391,0.266714594,0.688713156,587,-0.421998562,VA,Highland County,,1411,459,924,0.325301205,0.654854713,465,-0.329553508
51093,7673,11971,20481,0.37463991,0.584492945,4298,-0.209853035,VA,Isle of Wight County,,20772,8754,11797,0.421432698,0.56792798,3043,-0.146495282
51095,19091,21284,42737,0.446708941,0.498022791,2193,-0.05131385,VA,James City County,,41134,17854,22830,0.434044829,0.555015316,4976,-0.120970487
51097,1451,2059,3615,0.401383126,0.569571231,608,-0.168188105,VA,King and Queen County,,3645,1743,1863,0.4781893,0.511111111,120,-0.032921811
51099,4002,7338,11967,0.334419654,0.613186262,3336,-0.278766608,VA,King George County,,11287,4476,6603,0.396562417,0.585009303,2127,-0.188446886
51101,2752,5963,9088,0.302816901,0.656139965,3211,-0.353323063,VA,King William County,,8865,3326,5445,0.375183305,0.614213198,2119,-0.239029893
51103,2862,3520,6599,0.433702076,0.533414154,658,-0.099712078,VA,Lancaster County,,7052,3144,3749,0.44583097,0.531622235,605,-0.085791265
51105,1627,7542,9353,0.173954881,0.806372287,5915,-0.632417406,VA,Lee County,,9588,2593,6845,0.270442219,0.713913225,4252,-0.443471005
51107,99909,69633,180265,0.554234044,0.386281308,30276,0.167952736,VA,Loudoun County,,158648,81900,74794,0.516237204,0.471446221,7106,0.044790984
51109,6208,10507,17507,0.354601017,0.600159936,4299,-0.245558919,VA,Louisa County,,16404,6949,9207,0.423616191,0.561265545,2258,-0.137649354
51111,2226,3206,5577,0.399139322,0.574861036,980,-0.175721714,VA,Lunenburg County,,5726,2684,2969,0.468739085,0.51851205,285,-0.049772965
51113,2202,4418,6934,0.317565619,0.637150274,2216,-0.319584655,VA,Madison County,,6597,2637,3864,0.399727149,0.585720782,1227,-0.185993633
51115,1563,3515,5292,0.295351474,0.664210128,1952,-0.368858655,VA,Mathews County,,5364,1807,3488,0.336875466,0.650260999,1681,-0.313385533
51117,6571,8283,15177,0.432957765,0.545760032,1712,-0.112802267,VA,Mecklenburg County,,14813,6786,7855,0.458111119,0.530277459,1069,-0.07216634
51119,2107,3668,5994,0.351518185,0.611945279,1561,-0.260427094,VA,Middlesex County,,6067,2370,3619,0.390637877,0.596505687,1249,-0.205867809
51121,20015,19455,42695,0.468790256,0.455673967,560,0.01311629,VA,Montgomery County,,40938,19903,20006,0.486174215,0.488690214,103,-0.002516
51125,3677,4150,8247,0.4458591,0.50321329,473,-0.057354189,VA,Nelson County,,8225,4171,3944,0.507112462,0.479513678,227,0.027598784
51127,3545,8117,12163,0.2914577,0.667351805,4572,-0.375894105,VA,New Kent County,,10941,3555,7246,0.324924596,0.662279499,3691,-0.337354904
51131,3255,2686,6134,0.530648843,0.437887186,569,0.092761656,VA,Northampton County,,6481,3737,2676,0.576608548,0.412899244,1061,0.163709304
51133,2830,5089,8176,0.346135029,0.622431507,2259,-0.276296477,VA,Northumberland County,,7542,3186,4308,0.422434368,0.571201273,1122,-0.148766905
51135,2829,3712,6717,0.421170165,0.552627661,883,-0.131457496,VA,Nottoway County,,6844,3344,3409,0.488603156,0.498100526,65,-0.00949737
51137,5955,10511,17157,0.347088652,0.612636242,4556,-0.26554759,VA,Orange County,,16330,6870,9244,0.420698102,0.566074709,2374,-0.145376607
51139,2514,7824,10663,0.235768545,0.733752227,5310,-0.497983682,VA,Page County,,10205,3724,6344,0.364919157,0.621656051,2620,-0.256736894
51141,1768,6454,8489,0.208269525,0.760278007,4686,-0.552008482,VA,Patrick County,,8241,2417,5622,0.293289649,0.682198762,3205,-0.388909113
51143,9195,21742,31687,0.290182094,0.686148894,12547,-0.3959668,VA,Pittsylvania County,,30578,10855,19275,0.354993786,0.630355157,8420,-0.275361371
51145,4057,11875,16794,0.241574372,0.707097773,7818,-0.465523401,VA,Powhatan County,,15466,4066,11192,0.262899263,0.723651882,7126,-0.460752619
51147,4590,4099,9113,0.503676067,0.449796993,491,0.053879074,VA,Prince Edward County,,9224,5132,3952,0.556374675,0.428447528,1180,0.127927147
51149,6419,9157,16140,0.397707559,0.567348203,2738,-0.169640644,VA,Prince George County,,17180,7671,9350,0.446507567,0.544237485,1679,-0.097729919
51153,83093,54065,144854,0.573632761,0.373237881,29028,0.20039488,VA,Prince William County,,179648,103161,74371,0.574239624,0.413981787,28790,0.160257838
51155,4170,10314,15112,0.275939651,0.68250397,6144,-0.40656432,VA,Pulaski County,,14657,5287,8917,0.360715017,0.608378249,3630,-0.247663233
51157,1741,2532,4444,0.391764176,0.569756976,791,-0.177992799,VA,Rappahannock County,,4331,1971,2307,0.455091203,0.532671438,336,-0.077580236
51159,1347,2213,3651,0.368940016,0.606135305,866,-0.237195289,VA,Richmond County,,3768,1574,2160,0.417728238,0.573248408,586,-0.15552017
51161,16787,30857,50149,0.334742467,0.615306387,14070,-0.28056392,VA,Roanoke County,,53793,19589,33344,0.364155187,0.619857602,13755,-0.255702415
51163,3506,6671,10685,0.328123538,0.624333177,3165,-0.29620964,VA,Rockbridge County,,10155,4087,5898,0.402461841,0.580797637,1811,-0.178335795
51165,9361,25269,36536,0.25621305,0.691619225,15908,-0.435406175,VA,Rockingham County,,34783,10059,24173,0.289192997,0.694965932,14114,-0.405772935
51167,2328,9516,12195,0.190897909,0.780319803,7188,-0.589421894,VA,Russell County,,12063,3716,8177,0.308049407,0.677857913,4461,-0.369808505
51169,1579,8242,10055,0.1570363,0.819691696,6663,-0.662655395,VA,Scott County,,9964,2395,7439,0.240365315,0.746587716,5044,-0.506222401
51171,5269,14078,20335,0.259109909,0.69230391,8809,-0.433194,VA,Shenandoah County,,19289,6462,12526,0.335009591,0.64938566,6064,-0.314376069
51173,2661,9747,12825,0.20748538,0.76,7086,-0.55251462,VA,Smyth County,,12751,4169,8376,0.326954749,0.656889656,4207,-0.329934907
51175,3595,5035,8872,0.405207394,0.56751578,1440,-0.162308386,VA,Southampton County,,9261,4437,4733,0.479105928,0.511067919,296,-0.031961991
51177,24204,34619,62083,0.38986518,0.55762447,10415,-0.16775929,VA,Spotsylvania County,,57797,25150,31818,0.435143693,0.550513002,6668,-0.11536931
51179,27879,33840,65350,0.426610559,0.517827085,5961,-0.091216526,VA,Stafford County,,60338,27130,32429,0.44963373,0.537455666,5299,-0.087821936
51181,2069,1785,3976,0.520372233,0.448943662,284,0.071428571,VA,Surry County,,4302,2574,1671,0.59832636,0.388423989,903,0.209902371
51183,2874,2055,5036,0.570691025,0.408061954,819,0.162629071,VA,Sussex County,,5421,3350,2021,0.617967165,0.372809445,1329,0.24515772
51185,2895,15160,18495,0.156528792,0.819680995,12265,-0.663152203,VA,Tazewell County,,17712,3661,13843,0.206696025,0.781560524,10182,-0.574864499
51187,5165,11762,17791,0.290315328,0.661120791,6597,-0.370805463,VA,Warren County,,16636,6449,9865,0.387653282,0.592991104,3416,-0.205337822
51191,5548,19309,25715,0.215749563,0.750884698,13761,-0.535135135,VA,Washington County,,25582,7076,18141,0.276600735,0.709131421,11065,-0.432530686
51193,3723,4331,8291,0.449041129,0.522373658,608,-0.073332529,VA,Westmoreland County,,8689,4155,4116,0.478190816,0.473702382,39,0.004488434
51195,2687,11983,14991,0.179240878,0.799346274,9296,-0.620105397,VA,Wise County,,14937,3751,11041,0.251121376,0.739171186,7290,-0.488049809
51197,2765,10044,13250,0.208679245,0.758037736,7279,-0.549358491,VA,Wythe County,,12336,3782,8324,0.306582361,0.674773022,4542,-0.368190661
51199,12989,18823,34062,0.381334038,0.552609947,5834,-0.171275909,VA,York County,,33848,13165,20182,0.388944694,0.596253841,7017,-0.207309147
51510,57147,13241,74384,0.768270058,0.178008712,43906,0.590261347,VA,Alexandria city,,73470,52434,20205,0.713679053,0.275010208,32229,0.438668844
51520,1832,4884,6966,0.262991674,0.701119724,3052,-0.438128051,VA,Bristol city,,7356,2487,4776,0.338091354,0.649265905,2289,-0.311174551
51530,693,1432,2395,0.289352818,0.597912317,739,-0.308559499,VA,Buena Vista city,,2526,919,1564,0.36381631,0.619160728,645,-0.255344418
51540,17865,2951,22211,0.804331187,0.132862095,14914,0.671469092,VA,Charlottesville city,,21455,16267,4801,0.758191564,0.223770683,11466,0.534420881
51550,52554,53988,111827,0.46995806,0.482781439,1434,-0.012823379,VA,Chesapeake city,,110105,54999,53845,0.4995141,0.489033196,1154,0.010480905
51570,2367,5681,8427,0.280882876,0.674142637,3314,-0.39325976,VA,Colonial Heights city,,8593,2541,5937,0.295705807,0.690911207,3396,-0.3952054
51580,914,1349,2369,0.3858168,0.569438582,435,-0.183621781,VA,Covington city,,2329,1319,975,0.566337484,0.418634607,344,0.147702877
51590,11051,7306,18862,0.585886969,0.387339625,3745,0.198547344,VA,Danville city,,20169,12215,7756,0.605632406,0.384550548,4459,0.221081858
51595,1531,792,2367,0.646810308,0.33460076,739,0.312209548,VA,Emporia city,,2691,1793,886,0.666295058,0.329245634,907,0.337049424
51600,7363,3695,11854,0.621140543,0.311709128,3668,0.309431416,VA,Fairfax city,,11577,6636,4762,0.573205494,0.411332815,1874,0.161872679
51610,5810,1323,7667,0.757793139,0.172557715,4487,0.585235425,VA,Falls Church city,,7244,5006,2141,0.691054666,0.295554942,2865,0.395499724
51620,2516,1421,4040,0.622772277,0.351732673,1095,0.271039604,VA,Franklin city,,4351,2830,1496,0.65042519,0.343829005,1334,0.306596185
51630,6690,3731,11135,0.600808262,0.3350696,2959,0.265738662,VA,Fredericksburg city,,11396,7114,4054,0.624254124,0.355738856,3060,0.268515269
51640,680,1603,2363,0.287769784,0.678374947,923,-0.390605163,VA,Galax city,,2273,900,1332,0.395952486,0.586009679,432,-0.190057193
51650,41030,17802,61489,0.667273821,0.289515198,23228,0.377758623,VA,Hampton city,,71713,51733,19193,0.721389427,0.267636272,32540,0.453753155
51660,10100,6232,17693,0.570847228,0.352229695,3868,0.218617532,VA,Harrisonburg city,,15541,8650,6564,0.55659224,0.422366643,2086,0.134225597
51670,4722,3885,8968,0.526538805,0.433206958,837,0.093331847,VA,Hopewell city,,9011,5178,3737,0.574631007,0.414715348,1441,0.159915659
51678,1514,766,2448,0.618464052,0.312908497,748,0.305555556,VA,Lexington city,,2677,1484,1146,0.554351886,0.428091147,338,0.12626074
51680,14787,17979,35349,0.418314521,0.508614105,3192,-0.090299584,VA,Lynchburg city,,36242,15905,19752,0.438855472,0.545003035,3847,-0.106147564
51683,8395,5934,15210,0.551939513,0.390138067,2461,0.161801446,VA,Manassas city,,15154,8478,6463,0.559456249,0.426488056,2015,0.132968193
51685,3218,1732,5214,0.617184503,0.332182585,1486,0.285001918,VA,Manassas Park city,,4627,2873,1696,0.620920683,0.366544197,1177,0.254376486
51690,3531,2149,5873,0.601225949,0.3659118,1382,0.235314149,VA,Martinsville city,,6277,3855,2312,0.614146885,0.368328819,1543,0.245818066
51700,40997,23650,68432,0.599091069,0.34559855,17347,0.253492518,VA,Newport News city,,79169,50990,27224,0.644065228,0.34387197,23766,0.300193257
51710,51429,19875,75172,0.684151014,0.264393657,31554,0.419757356,VA,Norfolk city,,77925,55654,21366,0.714199551,0.274186718,34288,0.440012833
51720,383,1021,1456,0.263049451,0.701236264,638,-0.438186813,VA,Norton city,,1486,566,895,0.380888291,0.602288022,329,-0.221399731
51730,12005,1448,13717,0.875191368,0.105562441,10557,0.769628928,VA,Petersburg city,,15977,14377,1526,0.899856043,0.095512299,12851,0.804343744
51735,1599,5089,7114,0.224768063,0.715350014,3490,-0.490581951,VA,Poquoson city,,7098,1679,5312,0.236545506,0.748379825,3633,-0.51183432
51740,28462,12773,43000,0.661906977,0.297046512,15689,0.364860465,VA,Portsmouth city,,41860,28994,12407,0.69264214,0.296392738,16587,0.396249403
51750,2923,2637,6032,0.484582228,0.437168435,286,0.047413793,VA,Radford city,,5382,2732,2520,0.507617986,0.468227425,212,0.039390561
51760,74640,14254,94724,0.787973481,0.150479287,60386,0.637494194,VA,Richmond city,,92175,71037,19732,0.770675346,0.21407106,51305,0.556604285
51770,23403,16045,41728,0.560846434,0.384513995,7358,0.176332439,VA,Roanoke city,,37479,22179,14116,0.591771392,0.376637584,8063,0.215133808
51775,4212,7225,12129,0.347266881,0.595679776,3013,-0.248412895,VA,Salem city,,12270,4756,7289,0.387612062,0.59405053,2533,-0.206438468
51790,5329,5129,11144,0.478194544,0.460247667,200,0.017946877,VA,Staunton city,,11154,5710,5257,0.511923973,0.471310741,453,0.040613233
51800,23012,17206,41929,0.54883255,0.410360371,5806,0.138472179,VA,Suffolk city,,42381,24194,17778,0.570869021,0.419480428,6416,0.151388594
51810,76744,84389,171876,0.446507948,0.490987689,7645,-0.044479741,VA,Virginia Beach city,,195823,94163,99107,0.480857713,0.506105003,4944,-0.02524729
51820,3762,4798,9114,0.41277156,0.526442835,1036,-0.113671275,VA,Waynesboro city,,8772,3836,4789,0.437300502,0.545941632,953,-0.108641131
51830,5199,1921,7534,0.690071675,0.254977436,3278,0.435094239,VA,Williamsburg city,,7722,4901,2678,0.634680135,0.346801347,2223,0.287878788
51840,5161,4786,10574,0.48808398,0.452619633,375,0.035464347,VA,Winchester city,,10254,5089,4943,0.496294129,0.482055783,146,0.014238346
53001,1118,2740,4081,0.273952463,0.671404068,1622,-0.397451605,WA,Adams County,,4707,1516,3111,0.322073508,0.660930529,1595,-0.338857021
53003,3118,5712,9684,0.321974391,0.58983891,2594,-0.267864519,WA,Asotin County,,9883,3993,5647,0.404027117,0.571385207,1654,-0.16735809
53005,25173,45594,76907,0.327317409,0.592845905,20421,-0.265528495,WA,Benton County,,78874,27846,49105,0.353044096,0.622575247,21259,-0.269531151
53007,10770,15070,27415,0.392850629,0.54969907,4300,-0.156848441,WA,Chelan County,,30952,12519,17741,0.404464978,0.573177824,5222,-0.168712846
53009,15154,15685,32985,0.459420949,0.475519175,531,-0.016098226,WA,Clallam County,,35242,17231,17087,0.488933659,0.484847625,144,0.004086034
53011,90697,90590,195784,0.463250317,0.462703796,107,0.000546521,WA,Clark County,,181567,88822,88629,0.489196825,0.488133857,193,0.001062968
53013,523,1491,2171,0.24090281,0.686780286,968,-0.445877476,WA,Columbia County,,2222,634,1545,0.285328533,0.695319532,911,-0.409990999
53015,17842,24066,45485,0.392261185,0.529097505,6224,-0.13683632,WA,Cowlitz County,,40976,20897,19107,0.509981453,0.466297345,1790,0.043684108
53017,3600,7208,11467,0.313944362,0.628586378,3608,-0.314642016,WA,Douglas County,,14678,5047,9287,0.343847936,0.632715629,4240,-0.288867693
53019,1091,2178,3560,0.306460674,0.611797753,1087,-0.305337079,WA,Ferry County,,3391,1276,1966,0.37629018,0.579769979,690,-0.203479799
53021,7839,11358,20584,0.380829771,0.551787796,3519,-0.170958026,WA,Franklin County,,18940,6876,11657,0.363041183,0.615469905,4781,-0.252428722
53023,276,841,1232,0.224025974,0.68262987,565,-0.458603896,WA,Garfield County,,1275,335,912,0.262745098,0.715294118,577,-0.45254902
53025,7768,18482,28260,0.27487615,0.653998585,10714,-0.379122435,WA,Grant County,,27041,8746,17570,0.323434784,0.649754077,8824,-0.326319293
53027,11378,13269,26736,0.425568522,0.496297127,1891,-0.070728606,WA,Grays Harbor County,,28224,15692,11743,0.555980726,0.416064342,3949,0.139916383
53029,20766,18259,42425,0.489475545,0.430383029,2507,0.059092516,WA,Island County,,41319,21080,19251,0.510176916,0.465911566,1829,0.04426535
53031,12556,5986,20100,0.624676617,0.297810945,6570,0.326865672,WA,Jefferson County,,18717,11985,6113,0.640326975,0.326601485,5872,0.31372549
53033,657149,197781,910823,0.721489247,0.217145373,459368,0.504343874,WA,King County,,871654,599796,252090,0.688112485,0.289208792,347706,0.398903693
53035,60561,46762,118625,0.510524763,0.394200211,13799,0.116324552,WA,Kitsap County,,109919,59701,47468,0.543136309,0.431845268,12233,0.111291042
53037,7190,9845,18334,0.392167558,0.536980473,2655,-0.144812916,WA,Kittitas County,,15152,6462,8372,0.426478353,0.552534319,1910,-0.126055966
53039,3781,5390,9859,0.383507455,0.546708591,1609,-0.163201136,WA,Klickitat County,,9861,4373,5138,0.443464152,0.521042491,765,-0.077578339
53041,7236,16273,24995,0.2894979,0.65105021,9037,-0.36155231,WA,Lewis County,,26348,9772,15954,0.37088204,0.605510855,6182,-0.234628814
53043,1238,4095,5692,0.217498243,0.71943078,2857,-0.501932537,WA,Lincoln County,,5804,1649,4024,0.284114404,0.693314955,2375,-0.409200551
53045,11872,13539,27767,0.427557892,0.487593186,1667,-0.060035294,WA,Mason County,,27897,14568,12637,0.522206689,0.452987776,1931,0.069218912
53047,3980,6305,10893,0.365372257,0.578812081,2325,-0.213439824,WA,Okanogan County,,12781,5259,7151,0.411470151,0.559502386,1892,-0.148032235
53049,4597,5338,10667,0.430955283,0.500421862,741,-0.069466579,WA,Pacific County,,10477,5684,4484,0.542521714,0.42798511,1200,0.114536604
53051,1932,4364,6788,0.284619918,0.642899234,2432,-0.358279316,WA,Pend Oreille County,,6649,2501,3942,0.376146789,0.592871108,1441,-0.216724319
53053,160306,136046,322592,0.496931108,0.421727755,24260,0.075203353,WA,Pierce County,,332134,180478,144026,0.543389114,0.43363823,36452,0.109750884
53055,7053,2651,10589,0.666068562,0.250354141,4402,0.415714421,WA,San Juan County,,10345,6943,3061,0.671145481,0.295891735,3882,0.375253746
53057,26076,24330,54831,0.475570389,0.443727089,1746,0.0318433,WA,Skagit County,,42273,21875,19418,0.51746978,0.459347574,2457,0.058122206
53059,2207,2910,5587,0.395024163,0.520851978,703,-0.125827815,WA,Skamania County,,5326,2554,2624,0.47953436,0.492677431,70,-0.013143072
53061,167943,116433,309496,0.54263383,0.376201954,51510,0.166431876,WA,Snohomish County,,298759,169927,121642,0.568776171,0.407157609,48285,0.161618562
53063,86590,103846,208081,0.416136024,0.499065268,17256,-0.082929244,WA,Spokane County,,202088,91977,104797,0.455133407,0.518571118,12820,-0.06343771
53065,4348,11059,16438,0.264509064,0.67277041,6711,-0.408261346,WA,Stevens County,,17281,6014,10794,0.348012268,0.624616631,4780,-0.276604363
53067,65015,46219,122301,0.53159827,0.377911873,18796,0.153686397,WA,Thurston County,,111652,64879,43703,0.581082291,0.39142156,21176,0.189660732
53069,824,1328,2333,0.353193313,0.569224175,504,-0.216030862,WA,Wahkiakum County,,2285,1091,1115,0.477461707,0.487964989,24,-0.010503282
53071,7550,10775,19718,0.382898874,0.546455016,3225,-0.163556142,WA,Walla Walla County,,15155,5713,9098,0.376971297,0.600329924,3385,-0.223358628
53073,59402,40247,108223,0.548885172,0.371889524,19155,0.176995648,WA,Whatcom County,,91158,49743,38764,0.545678931,0.425239694,10979,0.120439237
53075,5521,5462,12128,0.455227573,0.450362797,59,0.004864776,WA,Whitman County,,14851,6910,7460,0.465288533,0.502323076,550,-0.037034543
53077,28484,39593,72306,0.393936879,0.547575582,11109,-0.153638702,WA,Yakima County,,62449,25945,35381,0.415459015,0.566558312,9436,-0.151099297
54001,1213,4509,6024,0.201361222,0.748505976,3296,-0.547144754,WV,Barbour County,,5733,1761,3804,0.307169021,0.663526949,2043,-0.356357928
54003,12287,28210,42770,0.287280804,0.659574468,15923,-0.372293664,WV,Berkeley County,,36804,14122,21956,0.383708293,0.596565591,7834,-0.212857298
54005,1783,6483,8654,0.206031893,0.749133349,4700,-0.543101456,WV,Boone County,,8434,2777,5414,0.329262509,0.641925539,2637,-0.312663031
54007,1315,3516,5063,0.259727434,0.694449931,2201,-0.434722497,WV,Braxton County,,4756,1985,2692,0.417367536,0.566021867,707,-0.148654331
54009,2549,6574,9540,0.267190776,0.689098532,4025,-0.421907757,WV,Brooke County,,9224,3984,5014,0.431916739,0.54358196,1030,-0.111665221
54011,11306,19648,32701,0.345738662,0.600837895,8342,-0.255099232,WV,Cabell County,,31744,13380,17779,0.421496976,0.560074345,4399,-0.138577369
54013,456,2023,2604,0.175115207,0.77688172,1567,-0.601766513,WV,Calhoun County,,2157,801,1288,0.371349096,0.597125637,487,-0.225776541
54015,566,2289,2958,0.191345504,0.773833671,1723,-0.582488168,WV,Clay County,,2989,922,1957,0.308464369,0.654734025,1035,-0.346269655
54017,360,2347,2826,0.127388535,0.830502477,1987,-0.703113942,WV,Doddridge County,,2743,571,2108,0.208166241,0.768501641,1537,-0.560335399
54019,4246,10263,15187,0.279581221,0.675775334,6017,-0.396194113,WV,Fayette County,,13971,5368,8304,0.384224465,0.594374061,2936,-0.210149596
54021,537,1889,2528,0.212420886,0.747231013,1352,-0.534810127,WV,Gilmer County,,2482,830,1580,0.334407736,0.6365834,750,-0.302175665
54023,510,4338,4945,0.103134479,0.877249747,3828,-0.774115268,WV,Grant County,,4572,713,3775,0.155949256,0.82567804,3062,-0.669728784
54025,3743,9499,13984,0.267663043,0.679276316,5756,-0.411613272,WV,Greenbrier County,,12872,4681,7873,0.363657551,0.611637663,3192,-0.247980112
54027,1576,6646,8557,0.184176697,0.776674068,5070,-0.592497371,WV,Hampshire County,,7972,2294,5514,0.28775715,0.691670848,3220,-0.403913698
54029,3247,8870,12642,0.256842272,0.701629489,5623,-0.444787217,WV,Hancock County,,11991,4571,7159,0.381202569,0.597031107,2588,-0.215828538
54031,1249,4544,6022,0.207406177,0.754566589,3295,-0.547160412,WV,Hardy County,,5149,1477,3523,0.286851816,0.684210526,2046,-0.39735871
54033,7675,18687,27868,0.275405483,0.67055404,11012,-0.395148557,WV,Harrison County,,25948,9660,15755,0.372283028,0.60717589,6095,-0.234892863
54035,2648,8959,12108,0.218698381,0.739924017,6311,-0.521225636,WV,Jackson County,,11465,3824,7360,0.333536851,0.641953772,3536,-0.308416921
54037,9458,13144,24007,0.393968426,0.547506977,3686,-0.153538551,WV,Jefferson County,,21776,10215,11090,0.469094416,0.509276267,875,-0.040181852
54039,27985,43464,74996,0.373153235,0.579550909,15479,-0.206397675,WV,Kanawha County,,74451,32190,41037,0.432364911,0.551194746,8847,-0.118829834
54041,1336,5245,6885,0.194045025,0.761801017,3909,-0.567755991,WV,Lewis County,,6243,1719,4349,0.27534839,0.696620215,2630,-0.421271824
54043,1435,5257,6988,0.205352032,0.752289639,3822,-0.546937607,WV,Lincoln County,,6747,2204,4336,0.326663702,0.642655995,2132,-0.315992293
54045,2082,9866,12315,0.169062119,0.801136825,7784,-0.632074706,WV,Logan County,,11901,3461,8186,0.290815898,0.687841358,4725,-0.39702546
54047,1429,4614,6179,0.231267195,0.746722771,3185,-0.515455575,WV,McDowell County,,6136,2086,3931,0.339960887,0.640645372,1845,-0.300684485
54049,6926,14592,22910,0.3023134,0.636927106,7666,-0.334613706,WV,Marion County,,21414,8905,11981,0.415849444,0.559493789,3076,-0.143644345
54051,2894,9565,13083,0.221203088,0.731101429,6671,-0.509898341,WV,Marshall County,,9849,3395,6208,0.344705046,0.630317799,2813,-0.285612753
54053,2069,7597,10115,0.204547701,0.751062778,5528,-0.546515077,WV,Mason County,,9713,3738,5706,0.384845053,0.587460105,1968,-0.202615052
54055,4689,17362,22919,0.204590078,0.757537414,12673,-0.552947336,WV,Mercer County,,21216,5416,15406,0.255279035,0.726150075,9990,-0.470871041
54057,2019,8957,11410,0.176950044,0.785013146,6938,-0.608063103,WV,Mineral County,,10784,2836,7687,0.262982196,0.712815282,4851,-0.449833086
54059,1365,7876,9469,0.14415461,0.831766818,6511,-0.687612208,WV,Mingo County,,8794,2421,6163,0.275301342,0.70081874,3742,-0.425517398
54061,14568,18278,35733,0.40769037,0.511515966,3710,-0.103825595,WV,Monongalia County,,31140,13664,16672,0.43879255,0.535388568,3008,-0.096596018
54063,1089,4337,5670,0.192063492,0.764902998,3248,-0.572839506,WV,Monroe County,,5152,1441,3571,0.279697205,0.693128882,2130,-0.413431677
54065,1568,5718,7635,0.205370007,0.74891945,4150,-0.543549443,WV,Morgan County,,7037,2361,4508,0.335512292,0.640613898,2147,-0.305101606
54067,1821,7169,9385,0.194033031,0.76387853,5348,-0.569845498,WV,Nicholas County,,8676,2635,5823,0.303711388,0.671161826,3188,-0.367450438
54069,5452,11077,17819,0.305965542,0.621639823,5625,-0.31567428,WV,Ohio County,,17541,6623,10577,0.377572544,0.602987287,3954,-0.225414743
54071,726,2388,3212,0.226027397,0.743462017,1662,-0.51743462,WV,Pendleton County,,3224,1067,2087,0.330955335,0.647332506,1020,-0.316377171
54073,620,2342,3130,0.198083067,0.748242812,1722,-0.550159744,WV,Pleasants County,,2807,942,1805,0.335589597,0.643035269,863,-0.307445672
54075,924,2474,3619,0.255319149,0.683614258,1550,-0.428295109,WV,Pocahontas County,,3553,1298,2167,0.365325077,0.609907121,869,-0.244582043
54077,2462,9501,12611,0.19522639,0.753389898,7039,-0.558163508,WV,Preston County,,11089,2916,7841,0.262963297,0.707097123,4925,-0.444133826
54079,5784,17455,24443,0.236632165,0.714110379,11671,-0.477478215,WV,Putnam County,,23501,7198,15926,0.306284839,0.67767329,8728,-0.371388452
54081,6362,21835,29311,0.217051619,0.744942172,15473,-0.527890553,WV,Raleigh County,,28499,7651,20375,0.26846556,0.714937366,12724,-0.446471806
54083,2724,7583,10816,0.251849112,0.701090976,4859,-0.449241864,WV,Randolph County,,9727,3325,6150,0.341832014,0.632260718,2825,-0.290428704
54085,490,3376,4040,0.121287129,0.835643564,2886,-0.714356436,WV,Ritchie County,,3749,762,2889,0.203254201,0.770605495,2127,-0.567351294
54087,1220,3772,5234,0.233091326,0.720672526,2552,-0.4875812,WV,Roane County,,5027,1928,2973,0.383528944,0.591406405,1045,-0.207877462
54089,1186,3444,4847,0.244687436,0.710542604,2258,-0.465855168,WV,Summers County,,4712,1612,2968,0.342105263,0.629881154,1356,-0.287775891
54091,1483,4701,6498,0.228224069,0.72345337,3218,-0.495229301,WV,Taylor County,,5887,1933,3827,0.328350603,0.65007644,1894,-0.321725837
54093,750,2557,3464,0.216512702,0.738163972,1807,-0.52165127,WV,Tucker County,,3118,876,2160,0.280949326,0.692751764,1284,-0.411802437
54095,505,2967,3621,0.139464236,0.81938691,2462,-0.679922673,WV,Tyler County,,3245,880,2291,0.271186441,0.706009245,1411,-0.434822804
54097,1763,6971,9180,0.19204793,0.759368192,5208,-0.567320261,WV,Upshur County,,8195,2143,5878,0.261500915,0.717266626,3735,-0.455765711
54099,3334,11077,15080,0.221087533,0.734549072,7743,-0.513461538,WV,Wayne County,,13923,4915,8673,0.353013,0.622926094,3758,-0.269913093
54101,554,2284,2955,0.187478849,0.772927242,1730,-0.585448393,WV,Webster County,,2744,939,1708,0.342201166,0.62244898,769,-0.280247813
54103,1348,4461,6191,0.217735422,0.720562106,3113,-0.502826684,WV,Wetzel County,,5808,2194,3449,0.377754821,0.593836088,1255,-0.216081267
54105,383,1903,2410,0.158921162,0.789626556,1520,-0.630705394,WV,Wirt County,,2163,673,1422,0.311141933,0.65742025,749,-0.346278317
54107,8327,25168,35256,0.236186748,0.713864307,16841,-0.477677558,WV,Wood County,,33600,11067,21980,0.329375,0.654166667,10913,-0.324791667
54109,1061,6527,7809,0.135868869,0.835830452,5466,-0.699961583,WV,Wyoming County,,7496,1575,5751,0.21011206,0.767209178,4176,-0.557097118
55001,3780,5983,10107,0.373998219,0.591965964,2203,-0.217967745,WI,Adams County,,10263,5537,4643,0.539510864,0.452401832,894,0.087109032
55003,4136,3428,7926,0.521826899,0.432500631,708,0.089326268,WI,Ashland County,,8342,5387,2816,0.645768401,0.337568928,2571,0.308199473
55005,7881,13595,22514,0.350048858,0.603846496,5714,-0.253797637,WI,Barron County,,22583,10883,11413,0.481911172,0.505380153,530,-0.023468981
55007,4953,4125,9491,0.521862817,0.434622274,828,0.087240544,WI,Bayfield County,,9759,6025,3597,0.61737883,0.368582847,2428,0.248795983
55009,53358,67192,127497,0.418503965,0.527008479,13834,-0.108504514,WI,Brown County,,128514,62433,64738,0.485806994,0.503742783,2305,-0.017935789
55011,2531,4049,6921,0.365698598,0.585031065,1518,-0.219332466,WI,Buffalo County,,7008,3569,3352,0.509275114,0.478310502,217,0.030964612
55013,2948,5412,8719,0.338112169,0.620713385,2464,-0.282601216,WI,Burnett County,,8634,3981,4541,0.461084086,0.525943943,560,-0.064859856
55015,9634,15345,26429,0.364523819,0.580612206,5711,-0.216088388,WI,Calumet County,,26336,11477,14519,0.435791312,0.551298603,3042,-0.11550729
55017,11875,17912,31471,0.377331512,0.569158908,6037,-0.191827397,WI,Chippewa County,,30914,15211,15371,0.49204244,0.497218089,160,-0.005175649
55019,4225,8645,13548,0.311854148,0.638101565,4420,-0.326247417,WI,Clark County,,13740,6173,7394,0.449272198,0.538136827,1221,-0.088864629
55021,13525,14160,29287,0.461808994,0.483490969,635,-0.021681975,WI,Columbia County,,30460,17158,13014,0.563296126,0.427248851,4144,0.136047275
55023,3426,3844,7678,0.446209951,0.500651211,418,-0.054441261,WI,Crawford County,,7791,4622,3064,0.59324862,0.393274291,1558,0.199974329
55025,217506,71270,304729,0.713768627,0.233879939,146236,0.479888688,WI,Dane County,,302845,215389,83459,0.71121861,0.275583219,131930,0.435635391
55027,13968,26643,42818,0.326217946,0.622238311,12675,-0.296020365,WI,Dodge County,,44379,18745,25190,0.422384461,0.567610807,6445,-0.145226346
55029,8026,8584,17398,0.461317393,0.493390045,558,-0.032072652,WI,Door County,,17607,9338,8109,0.530357244,0.460555461,1229,0.069801783
55031,11342,9657,22185,0.511246338,0.435294118,1685,0.07595222,WI,Douglas County,,22862,14855,7698,0.649768174,0.336715948,7157,0.313052226
55033,9025,11487,22029,0.40968723,0.521448999,2462,-0.111761769,WI,Dunn County,,21899,11303,10210,0.51614229,0.466231335,1093,0.049910955
55035,27271,23301,54080,0.50427145,0.430861686,3970,0.073409763,WI,Eau Claire County,,54595,30618,23218,0.560820588,0.42527704,7400,0.135543548
55037,666,1897,2651,0.251225952,0.715579027,1231,-0.464353074,WI,Florence County,,2615,952,1643,0.364053537,0.628298279,691,-0.264244742
55039,17391,31044,51094,0.340372646,0.607586018,13653,-0.267213371,WI,Fond du Lac County,,53272,22356,30329,0.419657606,0.569323472,7973,-0.149665866
55041,1583,2787,4507,0.351231418,0.618371422,1204,-0.267140004,WI,Forest County,,4643,2421,2172,0.52143011,0.467800991,249,0.053629119
55043,10047,12347,24051,0.417737308,0.513367428,2300,-0.095630119,WI,Grant County,,24160,13574,10255,0.561837748,0.424461921,3319,0.137375828
55045,9121,8693,18791,0.485391943,0.462615082,428,0.022776861,WI,Green County,,19302,11196,7848,0.580043519,0.406589991,3348,0.173453528
55047,2700,6210,9315,0.289855072,0.666666667,3510,-0.376811594,WI,Green Lake County,,9657,3790,5779,0.392461427,0.598426012,1989,-0.205964585
55049,6669,4809,12123,0.550111359,0.396683989,1860,0.153427369,WI,Iowa County,,12515,8099,4302,0.647143428,0.343747503,3797,0.303395925
55051,1273,2090,3477,0.366120219,0.601092896,817,-0.234972678,WI,Iron County,,3620,1783,1788,0.492541436,0.493922652,5,-0.001381215
55053,3821,4907,9202,0.415235818,0.533253641,1086,-0.118017822,WI,Jackson County,,9290,5297,3900,0.570182992,0.419806243,1397,0.150376749
55055,16559,23409,42324,0.391243739,0.553090445,6850,-0.161846706,WI,Jefferson County,,44136,20136,23489,0.45622621,0.53219594,3353,-0.07596973
55057,4100,7188,11736,0.34935242,0.612474438,3088,-0.263122018,WI,Juneau County,,11781,6237,5400,0.529411765,0.458365164,837,0.0710466
55059,35770,36025,75825,0.471744148,0.475107155,255,-0.003363007,WI,Kenosha County,,80661,44838,34942,0.555882025,0.43319572,9896,0.122686304
55061,3623,6616,10742,0.337274251,0.615900205,2993,-0.278625954,WI,Kewaunee County,,11018,5151,5746,0.467507715,0.521510256,595,-0.054002541
55063,32402,26384,62785,0.516078681,0.420227761,6018,0.09585092,WI,La Crosse County,,63212,36632,25711,0.57951022,0.406742391,10921,0.172767829
55065,3288,3977,7602,0.432517758,0.523151802,689,-0.090634044,WI,Lafayette County,,7928,4534,3313,0.571897074,0.417885974,1221,0.1540111
55067,3260,6436,10093,0.322996136,0.637669672,3176,-0.314673536,WI,Langlade County,,10482,4569,5810,0.435890097,0.554283534,1241,-0.118393436
55069,5370,8400,14563,0.368742704,0.57680423,3030,-0.208061526,WI,Lincoln County,,15152,7543,7444,0.49782207,0.491288279,99,0.006533791
55071,14563,23234,39991,0.364156935,0.580980721,8671,-0.216823785,WI,Manitowoc County,,42488,20382,21581,0.479711919,0.507931651,1199,-0.028219733
55073,26476,39010,68849,0.3845517,0.566602275,12534,-0.182050574,WI,Marathon County,,69637,32330,36568,0.464264687,0.525123139,4238,-0.060858452
55075,6243,12995,19979,0.312478102,0.650432955,6752,-0.337954853,WI,Marinette County,,20712,9868,10609,0.476438779,0.512215141,741,-0.035776362
55077,2808,4712,7813,0.359400998,0.603097402,1904,-0.243696403,WI,Marquette County,,7944,4112,3758,0.517623364,0.47306143,354,0.044561934
55078,1003,269,1279,0.784206411,0.210320563,734,0.573885848,WI,Menominee County,,1376,1191,179,0.865552326,0.130087209,1012,0.735465116
55079,288986,126091,434970,0.664381452,0.28988436,162895,0.374497092,WI,Milwaukee County,,490944,328090,158430,0.668283959,0.32270483,169660,0.345579129
55081,7047,11442,19554,0.360386622,0.585148819,4395,-0.224762197,WI,Monroe County,,19389,9505,9637,0.490226417,0.497034401,132,-0.006807984
55083,5886,13255,19924,0.295422606,0.665278057,7369,-0.369855451,WI,Oconto County,,19727,8810,10691,0.446596036,0.541947585,1881,-0.095351549
55085,8103,11677,20837,0.388875558,0.56039737,3574,-0.171521812,WI,Oneida County,,21577,10439,10905,0.483802197,0.505399268,466,-0.021597071
55087,38117,51579,95162,0.400548538,0.542012568,13462,-0.14146403,WI,Outagamie County,,94237,45565,47294,0.483514968,0.501862326,1729,-0.018347358
55089,20167,30458,53368,0.377885624,0.570716534,10291,-0.19283091,WI,Ozaukee County,,55565,19075,35991,0.34329164,0.647727886,16916,-0.304436246
55091,1345,2228,3746,0.359049653,0.594767752,883,-0.235718099,WI,Pepin County,,3696,1875,1793,0.507305195,0.485119048,82,0.022186147
55093,8380,11260,21089,0.397363554,0.53392764,2880,-0.136564086,WI,Pierce County,,20920,10213,10383,0.488193117,0.496319312,170,-0.008126195
55095,7568,13864,22691,0.333524305,0.610991142,6296,-0.277466837,WI,Polk County,,22494,10054,12075,0.446963635,0.536809816,2021,-0.089846181
55097,18524,17310,38123,0.4859009,0.454056606,1214,0.031844293,WI,Portage County,,39186,22052,16599,0.562752003,0.423595162,5453,0.139156842
55099,2671,4562,7560,0.353306878,0.603439153,1891,-0.250132275,WI,Price County,,7870,3882,3879,0.493265565,0.492884371,3,0.000381194
55101,42506,46620,93678,0.45374581,0.497662205,4114,-0.043916394,WI,Racine County,,102937,52887,49173,0.513780273,0.477699952,3714,0.036080321
55103,3577,4021,7962,0.44925898,0.505023863,444,-0.055764883,WI,Richland County,,8636,4964,3575,0.57480315,0.413964799,1389,0.160838351
55105,39336,31483,75043,0.52417947,0.419532801,7853,0.104646669,WI,Rock County,,80462,49158,30492,0.610946782,0.378961497,18666,0.231985285
55107,2171,4564,7029,0.308863281,0.649310001,2393,-0.340446721,WI,Rusk County,,7171,3391,3673,0.472876865,0.512201924,282,-0.039325059
55109,17496,26123,46819,0.37369444,0.55795724,8627,-0.184262799,WI,St. Croix County,,46009,19874,25475,0.431958965,0.553696016,5601,-0.121737051
55111,16050,15871,33848,0.474178681,0.468890333,179,0.005288348,WI,Sauk County,,31832,18718,12829,0.588024629,0.403022116,5889,0.185002513
55113,2846,4625,7767,0.366422042,0.595468006,1779,-0.229045964,WI,Sawyer County,,9003,4482,4436,0.497834055,0.492724647,46,0.005109408
55115,6056,12742,19697,0.307457989,0.646900543,6686,-0.339442555,WI,Shawano County,,20222,8990,11017,0.444565325,0.54480269,2027,-0.100237365
55117,22636,32368,58290,0.388334191,0.555292503,9732,-0.166958312,WI,Sheboygan County,,63272,28356,34282,0.448160324,0.541819446,5926,-0.093659123
55119,2398,6589,9417,0.254645853,0.699692046,4191,-0.445046193,WI,Taylor County,,9486,3761,5597,0.396479022,0.590027409,1836,-0.193548387
55121,5645,7370,13581,0.415654223,0.542669906,1725,-0.127015684,WI,Trempealeau County,,13456,7601,5703,0.564878121,0.423825803,1898,0.141052319
55123,6351,6994,14193,0.447474107,0.49277813,643,-0.045304023,WI,Vernon County,,14215,8031,5935,0.564966585,0.417516708,2096,0.147449877
55125,4769,8169,13453,0.354493422,0.607225154,3400,-0.252731733,WI,Vilas County,,13782,5931,7735,0.430343927,0.561239298,1804,-0.130895371
55127,18706,28848,50570,0.369903105,0.570456793,10142,-0.200553688,WI,Walworth County,,52115,22512,28962,0.431967764,0.555732515,6450,-0.123764751
55129,3283,5404,9059,0.362402031,0.596533834,2121,-0.234131803,WI,Washburn County,,9242,4435,4692,0.479874486,0.50768232,257,-0.027807834
55131,20854,51729,76246,0.27350943,0.678448706,30875,-0.404939276,WI,Washington County,,78558,23136,54709,0.294508516,0.696415387,31573,-0.401906871
55133,79199,145519,236269,0.335206904,0.615903906,66320,-0.280697002,WI,Waukesha County,,241084,77617,161567,0.321950026,0.670168904,83950,-0.348218878
55135,8303,16013,25491,0.325722804,0.628182496,7710,-0.302459692,WI,Waupaca County,,25801,11565,13989,0.44823844,0.542188287,2424,-0.093949847
55137,3802,7669,11961,0.317866399,0.641167126,3867,-0.323300727,WI,Waushara County,,12017,5330,6558,0.443538321,0.545726887,1228,-0.102188566
55139,37054,43447,85892,0.431402226,0.505832906,6393,-0.07443068,WI,Winnebago County,,88814,45410,42073,0.511293265,0.473720359,3337,0.037572905
55141,14232,21502,37712,0.377386508,0.570163343,7270,-0.192776835,WI,Wood County,,38762,18546,19685,0.478458284,0.507842733,1139,-0.029384449
56001,6888,7601,16420,0.419488429,0.462911084,713,-0.043422655,WY,Albany County,,16052,7445,7851,0.463805133,0.489097932,406,-0.025292798
56003,594,4067,5079,0.116952156,0.800748179,3473,-0.683796023,WY,Big Horn County,,5262,868,4269,0.16495629,0.811288483,3401,-0.646332193
56005,1324,15778,17935,0.073822135,0.879732367,14454,-0.805910231,WY,Campbell County,,17477,2163,14952,0.123762659,0.855524404,12789,-0.731761744
56007,1279,4409,6200,0.206290323,0.711129032,3130,-0.50483871,WY,Carbon County,,6461,2109,4152,0.326420059,0.642624981,2043,-0.316204922
56009,668,5520,6552,0.101953602,0.842490842,4852,-0.740537241,WY,Converse County,,6287,1089,5043,0.17321457,0.802131382,3954,-0.628916812
56011,271,3347,3771,0.071864227,0.887562981,3076,-0.815698754,WY,Crook County,,3657,426,3109,0.116488925,0.850150396,2683,-0.733661471
56013,4200,11167,16543,0.253883818,0.675028713,6967,-0.421144895,WY,Fremont County,,16817,5333,11072,0.317119581,0.6583814,5739,-0.341261818
56015,924,4418,5708,0.161878066,0.774001402,3494,-0.612123336,WY,Goshen County,,5758,1458,4178,0.253212921,0.725599166,2720,-0.472386245
56017,400,1939,2535,0.157790927,0.764891519,1539,-0.607100592,WY,Hot Springs County,,2495,523,1894,0.209619238,0.759118236,1371,-0.549498998
56019,638,3477,4349,0.146700391,0.799494137,2839,-0.652793746,WY,Johnson County,,4217,749,3362,0.177614418,0.797249229,2613,-0.619634811
56021,11572,24844,39945,0.289698335,0.621955188,13272,-0.332256853,WY,Laramie County,,38057,13807,23247,0.362797908,0.610846888,9440,-0.248048979
56023,1105,6779,8398,0.131578947,0.807216004,5674,-0.675637056,WY,Lincoln County,,8573,1287,7144,0.150122478,0.833313892,5857,-0.683191415
56025,6573,23523,32493,0.202289724,0.723940541,16950,-0.521650817,WY,Natrona County,,32057,8960,22129,0.279502137,0.69030165,13169,-0.410799513
56027,115,1116,1297,0.088666153,0.860447186,1001,-0.771781033,WY,Niobrara County,,1268,200,1022,0.157728707,0.805993691,822,-0.648264984
56029,2535,11115,14634,0.173226732,0.759532595,8580,-0.586305863,WY,Park County,,14492,2927,11234,0.201973503,0.77518631,8307,-0.573212807
56031,719,3437,4460,0.161210762,0.770627803,2718,-0.60941704,WY,Platte County,,4500,1223,3136,0.271777778,0.696888889,1913,-0.425111111
56033,2926,10266,14187,0.206245154,0.723620216,7340,-0.517375062,WY,Sheridan County,,14225,3618,10267,0.254340949,0.721757469,6649,-0.46741652
56035,644,3409,4297,0.149872004,0.793344194,2765,-0.64347219,WY,Sublette County,,4337,767,3472,0.176850357,0.800553378,2705,-0.623703021
56037,3233,12153,16661,0.194045976,0.729428006,8920,-0.53538203,WY,Sweetwater County,,16750,4773,11427,0.284955224,0.682208955,6654,-0.397253731
56039,7313,3920,12176,0.600607753,0.321944809,3393,0.278662943,WY,Teton County,,11356,6211,4858,0.546935541,0.427791476,1353,0.119144065
56041,1202,6154,8053,0.149261145,0.764187259,4952,-0.614926114,WY,Uinta County,,8453,1628,6613,0.192594345,0.782325801,4985,-0.589731456
56043,532,2911,3715,0.14320323,0.783580081,2379,-0.640376851,WY,Washakie County,,3911,794,3013,0.203017131,0.770391204,2219,-0.567374073
56045,294,2898,3334,0.088182364,0.869226155,2604,-0.781043791,WY,Weston County,,3323,422,2821,0.12699368,0.848931688,2399,-0.721938008
